11111111001001010000001000010000
11111111011011100110110110110010
00000000000101011101010011000111
11111111010110110011000001101110
00000000101011010111011100111100
11111111111101010111101010000001
00000000011100111010000111111001
00000000000001010110011000111100
00000000011011001000000101101101
00000000101000111101000101101110
00000000010000011010101100101110
00000000001100110100010110110011
00000000010110000111101001001001
11111111100101101000101011000111
00000000000011110100011111001110
00000000011010110111101100101101
00000000001100110011010110100110
00000000001001111001010011111100
00000000000001100000010111010111
00000000010001010001000100101010
11111111111100111110101010100010
11111111111000010111110101001111
11111111011000000000011010000111
11111111111111011011110001000000
00000000100100111000111011101101
00000000100111011101000010011100
11111111101011001101101110101100
00000000101001111010000100001001
00000000000011001101010110010001
11111111110101111100110011010001
00000000000010000010001000100010
00000000001010100101111110110011
00000000000001111010011010110111
11111111011010011101111000011000
11111111110010101101111110000111
11111110111111000001011100000111
00000000000111011011111101011100
00000000011111001101001100100111
00000000011100111010001111001011
00000000100110010010001111010111
11111111100011010100010001101010
00000000100110101011011100100100
11111111010111110100000101101001
00000000000101110100110111100110
11111111101110010001110100101100
11111111111001000100101101000111
11111111011100011111001001111010
11111111110001111111011110011001
00000000011001110110011011001111
00000000000010110010111110100000
11111111000110101010000001001001
00000000010010011000000000001001
00000000010110110010001010111010
00000000001000010010101110010001
11111111110111001100101111100101
00000000101111001001111010100101
11111111101100110000011011111000
11111111111110000001110111100100
11111111100001011010101000011111
11111111010010100100110000000010
11111111111011000110110110101110
11111111011101001101101000111001
11111111110110010011000000010110
00000000000001101111010111001011
11111111101100011000101011011100
11111111111000111011010001110001
00000000001100111000101011110011
11111111111000101100101111101101
11111111111111100010000000111010
11111111110110001011101110000110
00000000010001001111100001111111
11111111101110001110101111010000
00000000010100101001010111101100
00000000011100000001010101110000
00000000000000001000011011000011
00000000001110101110101010011100
00000000101011011101101011011000
11111111101001111111110001000010
11111111111010010000101111111110
00000000011111010001100110111010
11111111111101001110010101100010
11111111100001001000111100111011
11111111100001010110110011010101
00000000011111001101000111111111
11111111110010001010101110111110
00000000011110011001111100010000
00000000000111001101010000011111
00000000011100011101011111111000
11111111111010101100110110011110
11111111100100010010000110001100
11111111011100101101101110011001
11111111110110011100100101110100
00000000110010110101110001101000
11111111111011101001110100100000
11111111011101110000100100010000
11111111100101101010011111110010
00000000001101110110110101011010
11111111111001011111110111110011
00000000001001010000011111010100
00000000000001110101011111101010
00000001000011001111101000100011
11111111011111111110000111110000
11111111111001011111010010001111
00000000101101100011001000101000
11111111110101000110100110101111
11111111100101000110100111010001
11111111110100000100110000000110
11111111101000100010111100010111
11111111011000000110001111111000
00000000101001000101101011110110
11111111011000011010011001111000
00000000001000111111101110001010
11111111101100110100101011111000
11111111011010111011001100010011
11111111110110001000101100001000
00000000101101111100101110010010
00000000001101000101110001000011
00000001001001010011111001011010
00000000001101101110010101100011
00000000000110110111000110001000
11111111101100000110000101111011
11111111101100010000000011001001
11111111111010101010111000000110
11111111110111111101000011011101
00000000010010100111010100011110
00000000111110001100000100101000
11111111111011001101011011010110
00000000001010000011011100101110
00000000101010100010000011000010
11111111111000011000000001110010
11111111101100100011000011001001
11111111111001111001110001101100
11111111100110000000100001100000
11111111010000100111001001111101
11111111110110101110010000110010
00000000101010110001101100000010
00000000010101110111001100010111
11111111101001100101010100101110
00000000100110110000111010100110
11111111100010100101010101010100
00000000000101000111001010111111
11111111110111011001010001000110
00000000001100010111001110110100
11111111101100111001110001110111
00000000011011110101001100100000
00000000010100011111000000110100
11111111011110000101110101000001
00000000111101100111100111111010
00000000100111100000110110111100
00000000101111000110010110110111
11111111101010011100011010100100
11111111010110001011010101010010
11111111100100101011000111000111
00000000010110000000010101110000
11111111110011000101111100111100
11111111100001011001111100001010
11111111111011110000011011101101
11111111101001101011100100011010
00000000000110010100111000000010
11111111111000110111111000111001
11111111110000011010110101000110
11111111011001010001011110100111
00000000000101011010111111001010
00000000101101101100101011111011
00000000010100010000000001101101
00000000000110000101111010011001
11111111011000101011100010010100
11111111110100101001100100100101
00000000010000101001100001011101
11111111101111000101011101101000
00000000011000110001001000011011
00000000010110001111100100011100
00000000110000100101000111110110
11111111111101001001110001010010
00000000100100111110010100010000
11111111111010110010001000100111
00000000100101000001101111011000
11111111101000101100111001001011
11111111110111110110000100010000
11111111100101110110011001111111
11111111101111101111010110111111
11111111111000111000001111110111
00000000001110100011101001010100
11111111111100000101011100011111
00000000011100111010011010110101
00000000011111111101011011010010
00000000010000101101010100111111
00000000000110110010111100001010
00000000001111010100000111100110
00000000000100101011100010111010
00000000010101010010001001001100
11111111100001011001111010011101
11111111100100111111100101110011
11111111110100010000111100110111
11111111101010100011010111010010
11111111110100011010000011001010
11111111111110100111111010100001
00000000001101101100001001011111
00000000110101011111110000100101
11111111100110110110100010001011
00000000000000110101011001101101
00000000011100001110001010111110
11111111111001110001001100001010
11111111100111110110010000101000
00000000100001001111011101010000
00000000011111100110010110101111
11111111101100101110010010010001
00000000000100111001001010001110
00000000000110111111001011101001
11111111101110001111110110010111
11111111101110100111000010101010
11111111011100100100111011111010
00000000001001000001100011101101
11111111010010111000000100000101
00000000100111100010111010110111
00000000001010001100110010001001
11111111111101001111111011000111
11111111101110110100110100001000
11111111100001011011100011001010
00000000001101110011100011111100
00000000101010000111110010010010
11111111101110111001011000010001
00000000000001100001010111010011
11111111110100101100101000101110
00000000101010100010111110000010
11111111011100110000100011101010
00000000011110011111100001111010
11111111100100010010011001011110
00000000000011100111010010101001
00000000100110101000110011001001
11111111100111111001000001001110
00000000100000101110110011011000
00000000110000001110110010110111
11111111110100101000000011000110
11111111110001100110101001001101
11111111101001010100001110011010
11111111111101011000010001101011
00000000001111001001001001011000
11111111100000101001110000001010
00000000010010100010101101011001
00000000001010100110111101101010
11111111111110001001101101101100
00000000000011111110000100000110
00000000101000111001001000111100
11111111110110001111010010011001
00000000001000011000000101001001
11111111101111001010001011000110
00000000010111010110001011010110
00000000000101010101001001010001
11111111010101001111110110011100
00000000010011101011111111011011
00000000000100111000000110110100
11111111010000000001000001000111
11111111100111010010010110001110
00000000010010110111100000100010
11111111111001001100000000110001
