00000000000000010101111011110111
00000000000000010001010000100110
11111111111111111111010101110011
00000000000000000001110011110100
11111111111111110101000110010111
11111111111111111011010111110000
00000000000000000000000010010101
00000000000000100100011100001000
11111111111111100101011011010111
11111111111111110101111000100001
00000000000000011011101010011111
11111111111111010010001101011101
11111111111111100101100101111010
00000000000000100000101000010100
00000000000000010001101010110010
11111111111111111111101000010000
11111111111111100010111110011111
00000000000000000000111011110011
00000000000000001011100100001001
00000000000000000100101011000001
11111111111111100010011000011111
00000000000000010110011011101110
00000000000000001001111111011101
00000000000000000011010001011010
11111111111111110010001000001101
00000000000000000011000111111000
11111111111111111011110000110111
11111111111111101100001110111100
00000000000000000100111101101000
00000000000000001101000010110001
00000000000000000100011111111100
11111111111111110110110000101111
11111111111111111100110111000101
11111111111111111100101111100001
11111111111111010110010111111111
11111111111111111111111100000111
11111111111111111001000011101101
00000000000000100110011000001011
11111111111111100101110011011011
11111111111111110000010100101101
00000000000000001110111011100101
11111111111111100111101011000001
11111111111111111111010000101101
11111111111111110001110011000001
00000000000000010110111010011101
11111111111111101000000011001101
00000000000000010110010011100011
00000000000000011011110010010111
11111111111111110110011111111110
11111111111111101100000011100001
00000000000000010010101001111110
11111111111111110101001100001011
00000000000000000110010101100000
00000000000000010000111111011110
00000000000000011001010111000000
11111111111111110101100111000010
11111111111111101110100101100000
00000000000000100001010000010110
00000000000000010000110111111000
00000000000000000110010000010010
11111111111111111100101001000101
11111111111111111101011101110011
11111111111111101001010100111001
00000000000000100010111010100011
00000000000000010010001111010110
00000000000000001011001011010111
11111111111111101110111000111100
11111111111111110101001001101111
11111111111111101010001111010010
11111111111111111011000000110101
00000000000000001001100101011110
11111111111111111010000000111011
00000000000000000001110111110011
00000000000000000101001101111100
11111111111111101111000110011111
00000000000000000011010100011110
11111111111111101011010000100111
11111111111111111001111011011001
11111111111111111111101110101101
00000000000000000010001011001011
11111111111111100011010000101101
11111111111111100010001011101110
00000000000000000110000100000101
11111111111111111111010001010100
11111111111111101100101110001110
00000000000000001100000011111111
11111111111111101101001000011010
11111111111111100000010111010001
00000000000000000011100001101100
00000000000000000010010110101111
11111111111111111011101110110100
00000000000000101000110111010001
00000000000000011011101001110000
00000000000000000101110100100010
00000000000000000011111110101010
00000000000000010010111100000000
00000000000000000101101110110011
00000000000000010101111011111001
11111111111111110010001111100101
00000000000000001101100101010111
11111111111111101000001101010101
11111111111111111101111110010001
00000000000000001001001110000001
11111111111111010010110011010101
11111111111111111100000111011001
00000000000000000100001010100010
11111111111111100011110101001011
11111111111111110101100101111010
00000000000000010000101000000010
11111111111111101000011000010010
11111111111111110000001011110010
11111111111111101111101001100110
00000000000000100101001010011011
11111111111111110011001000100110
11111111111111111101010011011101
00000000000000001001110110010010
11111111111111101110110010001100
00000000000000010101110000110101
11111111111111101011101100110010
11111111111111110001001100011001
11111111111111111001111001011100
11111111111111110010001011100100
11111111111111111100010100010010
00000000000000100100000111000010
00000000000000010011001100000011
11111111111111111101001011000100
11111111111111100111000000011011
11111111111111010001101000110010
00000000000000010011110100100111
11111111111111111000100011110111
11111111111111110110000101101001
11111111111111111011010011110001
00000000000000001100101000001000
11111111111111110011111111010011
00000000000000001101100011111100
00000000000000010010000111011101
00000000000000010110001010010100
00000000000000000101100101010010
11111111111111101101110010100110
11111111111111111000100101011000
00000000000000001111110000000111
11111111111111100101010101010100
11111111111111111000010010100011
00000000000000000000111001000010
11111111111111111011000001100010
11111111111111111010011010011100
00000000000000001110001111111110
11111111111111010110101100000100
00000000000000011001111001110110
00000000000000100101001100011101
11111111111111100110101011000010
00000000000000000000100000110111
00000000000000000111111010011110
00000000000000010100000101010011
11111111111111111010011110101110
00000000000000000100101100101001
11111111111111110001110111000000
11111111111111100110100010110101
00000000000000010001111001011100
11111111111111101001101000001111
00000000000000100001101110010001
11111111111111111111011000001010
00000000000000010010000011110001
11111111111111110100011101001100
11111111111111111111110001111110
11111111111111101010000111101100
11111111111111110110001111011110
11111111111111110010111100010100
00000000000000000111011000001011
00000000000000000000100110011111
00000000000000010011010011011011
11111111111111101110000001000011
11111111111111101100100100001010
00000000000000000001001001111101
00000000000000000101100101010010
11111111111111101000001011011111
11111111111111110100110101100100
00000000000000010111010000011110
00000000000000001010001011110010
00000000000000000010110111000100
11111111111111111001111110010010
11111111111111110011000000111010
11111111111111011101001010111000
00000000000000000001011110101000
11111111111111101010100100111000
00000000000000001111000110100011
11111111111111111001011000000110
11111111111111101100111110001011
11111111111111110010000000011011
00000000000000000011001001001101
00000000000000010111000000101101
11111111111111100100100111001111
00000000000000001111010001001100
11111111111111101100010100011111
11111111111111111111111010011000
11111111111111110111001001111101
11111111111111100101110000111000
00000000000000000111110001100100
11111111111111101110101010011010
00000000000000001000001000000110
11111111111111111001000101000011
11111111111111111001011101110011
11111111111111111100111100011011
11111111111111111110110111011111
11111111111111111101110111101110
00000000000000000110101010101101
00000000000000100100110101100010
00000000000000000010110111100111
11111111111111110101100001101101
11111111111111111011011010110110
11111111111111111000001000100111
00000000000000000010011101110010
11111111111111111110110010011110
00000000000000010011100100010110
11111111111111101010111100010110
00000000000000001100100100000010
11111111111111110000110000001000
11111111111111010101110011111101
11111111111111110010111100011010
00000000000000000110100111010101
11111111111111111000111100000110
11111111111111111111110110100101
11111111111111110010011000111010
00000000000000100010111001111011
00000000000000001100011111011100
00000000000000001111110010111000
11111111111111111100100101001010
11111111111111110010100011101010
00000000000000101000110111011110
00000000000000001100100100001000
11111111111111111101111100010100
11111111111111101001111111010010
11111111111111111100110111010100
00000000000000010111000100000101
00000000000000010000010011011100
00000000000000001101010011110111
00000000000000000010111011101100
11111111111111111111010100011000
11111111111111111011111011001100
00000000000000001111000111111000
00000000000000000001011110111011
11111111111111110011111100010100
00000000000000011111111001000111
00000000000000000001110101111110
00000000000000010101001100101011
00000000000000001001111100011011
11111111111111111101010000001011
11111111111111110011111110000011
00000000000000000110000101001000
11111111111111100100011011001010
11111111111111111111100011001000
11111111111111101110011101011010
00000000000000000011001011010010
00000000000000001110101000000010
11111111111111110111010100000100
00000000000000101010111001110100
