11111111111111110110111010111000
00000000000000000001110001111010
00000000000000001110011110001011
00000000000000011111110111101110
00000000000000000000110001111000
00000000000000010010100110011100
00000000000000001110011001100001
11111111111111101011000110001000
00000000000000001000111001001111
00000000000000000011110110110011
00000000000000001011111011111111
11111111111111111101110100001111
00000000000000000111100000100011
11111111111111100110101100011011
11111111111111101000100110011011
11111111111111110010001011100111
11111111111111111011101101010010
00000000000000010000100001010111
00000000000000101001000101101011
00000000000000000111100000110010
00000000000000010001000110101110
11111111111111010101111100101101
00000000000000010101000110110001
11111111111111111110011111110110
00000000000000000101011110000111
00000000000000010101100001001010
11111111111111111011000000000001
11111111111111101110111000011001
00000000000000011101000100010011
11111111111111011111110001110010
11111111111111110010000000001001
11111111111111100000100101011111
11111111111110111111010001011100
00000000000000010010010111110011
11111111111111001100111011000001
11111111111111101001110000000110
00000000000000000011000100010100
11111111111111110101100000101001
00000000000000000001010100001011
00000000000000011000001011110010
00000000000000000000110011100001
11111111111111110110001111000101
00000000000000111011010110100110
00000000000000100111111111001010
00000000000000011010011010101101
11111111111111111000110010010001
00000000000000001110101111100000
11111111111111010000001000001100
00000000000000010001101011010010
11111111111111111011010111101111
00000000000000100101101001101110
00000000000000000101010100100001
00000000000000000110010101101110
11111111111111110000000110000111
11111111111111110010111011101110
11111111111111110111011000010101
00000000000000011011000111011111
11111111111111111010010000010010
11111111111111101100000010000011
00000000000000100011101101010111
11111111111111100101101111001101
11111111111111011110100110101010
00000000000000011001011000010001
11111111111111011000101010011101
11111111111111111101101011000001
00000000000000000011101101000110
00000000000000010110101011011111
00000000000000001010101101010100
11111111111111101000000001001001
00000000000000001011000101011110
00000000000000000011100000100011
00000000000000001011101101000100
11111111111111011110001010111110
00000000000000000010011010111011
00000000000000000010010011111000
00000000000000100010111010101111
11111111111111001001101100101100
00000000000000000100111100001001
00000000000000000010110110011110
11111111111111110101011101110101
00000000000000100010111000111010
11111111111111111011001001000101
11111111111111101001100000011111
11111111111111011100111100011100
11111111111111101110110111111100
11111111111111101101001100011011
00000000000000001111001111101011
00000000000000001101001111000100
00000000000000001000111100011010
00000000000000110101000011101100
00000000000000000011111011100110
00000000000000001101101010111011
00000000000000010101010111000010
00000000000000001000011110111110
11111111111111111011111110010010
11111111111111110111010011101111
11111111111111111010001000100111
11111111111111100101111101111000
11111111111111110011010110011100
11111111111111111100100111110100
00000000000000000110001011000011
00000000000000000111010010011010
11111111111111100000111010011010
00000000000000000111000100100010
11111111111111110011110000110000
00000000000000000101110011001000
11111111111111110110000001000111
11111111111111010111111111010000
00000000000000110010110011111010
00000000000000100000111110011000
00000000000000010101101001100011
00000000000000010000100111000100
11111111111111100100011001000010
00000000000000001100100101101000
11111111111111110000111001100101
11111111111111100000100110000010
11111111111111110011001110000100
11111111111111101110001011010100
00000000000000011001100000000001
00000000000000010111110001101110
11111111111111011011011000100000
11111111111111101010000011110010
11111111111111100101100001000110
11111111111111101111001110001101
00000000000000001001101100100010
11111111111111110010011100001100
00000000000000010111100000010000
00000000000000011100000100101101
11111111111111101011100011110110
11111111111111111001100100011101
11111111111111110000110000011110
11111111111111111100001010110000
00000000000000010001111110101010
00000000000000010001001001101011
11111111111111010101101000100110
11111111111111011110110000011100
00000000000000001010101101010000
00000000000000001010001111010010
11111111111111100000001000001101
00000000000000001010111111101111
00000000000000000110010100111000
00000000000000110101100100001010
11111111111111101111100011000111
00000000000000010100100110101001
00000000000000000110111101110110
00000000000000101101000100000010
11111111111111101000101110100111
11111111111111001101010101100011
11111111111111111101101111110100
11111111111111001100000001011000
00000000000000011011011000100011
11111111111111100111011010001111
11111111111111010101110001110100
11111111111111010001110011101100
00000000000000011001010110110101
11111111111111110111111001011100
11111111111111011010100011001010
11111111111111101001011001111100
11111111111111110101100011111101
00000000000000010111011010010100
11111111111111011000101100110010
00000000000000101000010100101011
00000000000000000111101101110000
11111111111111111010000111001011
11111111111111101010101000110110
00000000000000110100011000000111
00000000000000011011001110110100
00000000000000000111001001101111
00000000000000000101001111000100
00000000000000001001111100001011
11111111111111100111011010110111
00000000000000000010111110101001
11111111111111100010000011000110
11111111111111110111011101101111
11111111111111011100010000010011
00000000000000001100100001101001
11111111111111101110101100100100
00000000000000100011011100101111
11111111111111010010000010110011
00000000000000001100001001001100
00000000000000110001001111101110
00000000000000010101010000011111
00000000000000010111101101000011
11111111111111111110011111010110
11111111111111111010111101011100
00000000000000101011110010100101
00000000000000011101101000000010
11111111111111110111111110101100
00000000000000000000000101111110
00000000000000011000000000000011
11111111111111101111100110101000
00000000000000100000010100110000
11111111111111111010000010000100
00000000000000001111000010011011
11111111111111111100111010001010
00000000000000000111011000010101
11111111111111101100011010000000
00000000000000001011000011001111
00000000000000011111100101010110
11111111111111101111101001001101
11111111111111111111111110010010
11111111111111110110010111000101
00000000000000101010000100000011
11111111111111101000011010011001
11111111111111011110001001001000
11111111111111110001110101000001
11111111111111100000011000111111
11111111111111010111111001111101
11111111111111111111111101010101
11111111111111100011100100010010
11111111111111100100100101010101
00000000000000101101110101010001
11111111111111101111111111101001
11111111111111101010010011110010
00000000000000001110101100101001
00000000000000000110000000110111
11111111111111111100010111110110
00000000000000100100111111101011
11111111111111100110101010010101
00000000000000011110000101110001
00000000000000000010010111111000
00000000000000111000011111101101
00000000000000000001111000100001
11111111111111100001100111110011
00000000000000000010100000110111
00000000000000100111010001010001
00000000000000000101101001110010
00000000000000000010011001001011
11111111111111111100011000111001
00000000000000100111111100101111
00000000000000001001110001001010
00000000000000000000010100100001
11111111111111111101010001100111
00000000000000110000001111001101
11111111111111100100111101011110
00000000000000100100011110001100
00000000000000010110001110101001
11111111111111111011111111111001
11111111111111101101000111000110
11111111111111111000000101000010
00000000000000010000111110111100
11111111111111111000110101110000
00000000000000000000011011100011
11111111111111101111010111011001
00000000000000100010001111000000
11111111111111110101100010000010
00000000000000000101111011001101
00000000000000000010011001000001
11111111111111100110000101010110
00000000000000000001011101111110
11111111111111100010011111000100
00000000000000111111010111001101
00000000000000000111010011001010
11111111111111010000000010100010
11111111111111110011110110111100
11111111111111011001000011001011
