00000000001010111101111100111001
00000000000000111001111010000100
11111111111111101010111001111101
00000000001000101000010010110110
11111111111010100011001011001011
00000000010010001110000101000100
00000000000000000001001011010111
11111111111101101011111000001110
11111111110010101101101010111011
11111111101001000110101101010011
00000000001101110101001111110111
11111111111010111100010000110011
11111111110010110010111100011100
11111111111111110100000111110010
00000000001000110101011001101100
00000000010000010100001011000010
11111111110001011111001110111000
00000000000010010101100000010000
00000000000101110010000100101110
00000000000000011101111001101010
11111111110001001100001111001011
00000000000001101000101101000100
00000000000100111111101111100111
00000000001011001101110111111110
11111111111001000100000110001011
11111111110110000111011110011010
11111111111101111000011011000011
00000000000001100011111100010100
00000000000010011110110100100111
11111111111011011000010111110000
00000000000010001111111110010111
00000000000110100001011000011110
11111111111110011011100010111011
11111111111111111110000011011111
11111111101011001011111110110011
11111111111110010111110000011011
11111111111100100001110101111111
11111111111000001010010101111100
11111111110010111001101100111101
00000000010011001100000101010100
00000000000111011101110011000110
11111111111000111001011111111000
11111111111111101000010110001000
11111111110011110101100000010010
00000000001011011101001111000011
00000000001101111001001100001011
00000000001011001001110001110111
11111111110100000001100101100111
11111111111011001111111110011000
11111111111010100110000101111101
00000000001001010100111111011110
11111111110110000001101111011101
00000000000011001010110000001000
11111111111010110011100000011110
00000000001100101011100001010000
00000000001000011111101111100110
11111111110111010010101111010100
00000000000011001000001001000000
00000000001000011011111101001000
00000000010000101000001100010000
11111111111110010100100010000000
00000000010001011101010010010010
11111111110100101010011100011110
11111111111110101110111001100100
00000000001001000111101011100000
11111111111010100100110111010100
11111111110111011100011101111010
00000000000101100101101011101110
11111111110101000111101000010010
11111111111101000000011101100000
00000000000100110010101111010100
11111111111101100000011010001110
00000000000000111011111001110110
00000000000001101010001111010111
11111111110111100011001110011110
00000000000010100110111101101001
11111111110101101000010010110111
00000000000001000101100101001100
11111111111111110111010110001111
11111111111100111101101100100010
11111111110001101000010110001000
11111111111111101000101001110011
00000000000011000010000011000100
11111111110001000101110101100101
11111111110110010111000101110110
11111111110000001011100111110111
11111111110110100100001100101110
00000000000110000001111111110001
00000000000001110000110110000100
00000000010100011011101001011011
11111111111101110111011001100000
00000000000001001011010111011101
00000000001101110100111000111011
00000000001001011110000000001101
00000000000001111111010101011001
00000000000010111010010000111111
00000000000010110111011001011111
00000000000110110010101100000001
11111111111001000111110010000101
00000000001010111101111100111011
11111111110100000110101010000000
11111111101001011001101001101110
00000000000100100111000000111010
11111111111110111111001000010100
11111111111110000011101011111100
11111111111010110010111100011100
11111111110001111010100100101100
00000000000010000101010001100000
00000000001000010100000001001110
11111111110111110100110010011001
11111111111000000101111000110110
11111111110100001100001000100111
00000000010010100101001110001101
00000000000100111011001000101110
11111111111110101001101110100101
11111111111001100100010011010000
11111111110111011001000101101001
11111111111000100110001100011111
11111111110101110110010111111111
00000000001010111000011011000001
11111111111100111100101110010010
00000000010010000011100010000100
11111111111110001010001000110100
11111111111001000101110010010010
00000000001001100110000010101001
11111111101000110100011000001101
11111111110011100000001101001001
11111111111110100101100001111001
00000000001001111010010100010001
11111111111101101001111000011011
11111111111011000010110100001111
11111111111100010001111010111001
00000000000110010100000100011111
00000000001001000011101111001100
00000000000110110001111110001001
11111111111001111111101001000100
00000000001011000101001010111011
11111111111100010010101100000010
11111111110110111001010010101111
00000000000010110010101000110000
00000000000111111000000100000110
00000000000000011100100001001011
11111111111100001001010001001000
11111111110010101010101001100111
11111111111101100000110001001010
11111111101011010110000001000100
00000000000111000111111111001100
11111111111101001101001101011010
00000000001100111100111011011001
00000000000000010000011011110111
11111111110011010101100000010001
00000000010010100110001111101111
00000000000011111101001111000100
00000000000010010110010100101010
11111111111101001111010111000010
00000000001010000010101010011000
11111111111000111011011111101010
11111111110100110100000111110011
00000000001000111100101110010010
11111111110011010001011010001001
00000000010000110111001001000111
11111111111010001110100101111001
00000000001001000001111001001111
11111111111111101100000101010101
11111111111111111000111111000101
11111111111001011110001010000010
11111111111011000111101110110011
11111111110101000011110101110010
00000000000011101100000101010110
11111111110111000000100000110010
00000000001001101001101110100100
00000000000000010011010000000100
11111111110110010010000100101101
11111111110100000101101111000010
00000000000010110010101000110001
00000000000000100100111101111000
11111111111010011010110001110001
00000000000001011011100010111010
00000000000101000101111000110101
00000000001011101000001111100100
11111111111100111111001000010101
00000000000000101111010011110001
11111111101110100101011011010111
11111111111001100000011101011111
11111111110101010010011011101010
11111111110110011111000101000010
11111111111100101100000010000100
00000000000111100011010001101100
11111111111001000000001101000111
11111111110010010011100111000011
00000000001011100000010110111011
00000000000001100100100110111011
00000000000111101000100110100000
11111111111011100100111101110111
11111111111111111101001011110010
11111111110110001010001111010111
11111111110010111000011011000100
00000000000100000100000010111000
11111111110111010101001100100110
00000000000011111000110001111110
11111111111100100010100000100101
11111111111111011011110000000011
11111111111110011110001101010101
11111111111100101110111001100011
11111111111110111011110110100101
00000000000001011011110011010100
00000000010010011010110001101111
00000000000011010101010110011100
11111111111010110000110110000101
00000000000001001110111001100011
11111111111100000100010011010001
11111111111101101101011010100011
11111111111111011001001111011100
00000000000110010010000001011011
11111111110101011110001010000100
00000000001001110010001011010001
11111111111000011000000100000110
00000000000011010011101010010011
11111111111001011110001101010100
11111111101010111001111101010111
11111111111100011110000011011110
00000000010001011100111110101010
11111111111001001100011100010010
11111111111111111011010010100010
00000000000110001111101101111101
11111111111001010001110100010110
11111111111110010010100101011101
00000000000111111001011100100100
00000000010100011011110000000000
11111111110100111111101001000110
11111111111110111110001010000010
00000000000110010010000100101100
11111111111110011011101001100000
00000000000110101001111011101100
00000000001000001001101110100100
00000000001011100010000011000100
00000000000001011101110110011001
00000000000111100011111100010011
11111111111101111101100101111111
11111111111111101010001100000101
00000000000000101111011101100110
00000000000000111010111110111000
00000000001111111100100100011100
11111111111001111110001010000010
00000000001010100110010110010011
11111111111001111111000001101111
11111111111110101000000101101111
00000000000100111110001101010011
00000000000011000010100011110110
11111111110111001110101100011110
11111111111111110001100011111100
11111111110010001101100100011000
00000000000001100101101000011101
00000000010101011100111011010111
11111111111011101010000010010001
00000000000111010100000001001111
