0000000000110011
1111111111110110
1111111110111100
1111111111111010
1111111111101010
0000000000001010
0000000001000100
1111111110100001
1111111111100000
0000000000101010
1111111111010101
0000000001100011
1111111111100000
0000000000110010
1111111110111000
0000000000111011
0000000000110111
0000000001011110
1111111111010111
1111111111001000
1111111111111011
1111111110111011
1111111111010101
0000000000100001
1111111111010101
0000000001001010
0000000000000111
0000000001100011
0000000000011001
0000000000000011
1111111110010110
1111111111101111
1111111110011011
1111111110000111
1111111111111011
1111111111101110
1111111110000001
1111111110000100
1111111110001011
0000000001100010
0000000001001100
0000000001111110
1111111111100110
1111111110111101
1111111110110011
1111111111100011
0000000001101001
1111111110011011
0000000000011000
0000000001001000
0000000000010001
1111111111101110
1111111111010010
0000000001000110
1111111111010100
0000000001000001
1111111111011100
0000000000110001
1111111111000110
0000000000110001
0000000001000101
0000000000110101
0000000001110111
1111111111100011
0000000000100101
1111111111011011
1111111110100000
1111111111111000
1111111111111000
0000000000001101
0000000000100110
0000000000101010
1111111111001101
1111111110001110
1111111110011111
1111111110100111
0000000000010101
0000000001111100
1111111111110001
1111111111010000
1111111111011110
0000000000111000
0000000001010011
1111111111011111
0000000001100101
0000000001100100
1111111110101100
0000000001011010
0000000001100000
1111111111011100
0000000001101011
1111111111010010
0000000001111010
0000000000000110
1111111111000010
1111111110001101
1111111111000110
1111111111100100
0000000000011011
0000000000111100
1111111110000111
0000000001110100
1111111110010100
0000000001000000
0000000001000001
0000000000100010
1111111111111110
0000000000111000
0000000000011101
1111111110101110
1111111110101011
1111111110001110
1111111111010110
1111111111101111
1111111111111011
1111111110100000
0000000000011111
1111111111000001
1111111110101010
0000000000111011
1111111111001010
1111111111111011
0000000001001011
1111111110000101
1111111110000110
1111111111001100
1111111110100100
0000000001010001
1111111110101010
1111111111011111
0000000000111100
0000000000110001
1111111111000100
1111111111100001
0000000000011101
1111111110100110
0000000001000000
1111111110000010
0000000000100111
0000000001011011
1111111111100010
1111111111010011
0000000001100110
1111111111111000
1111111110110111
0000000001011010
1111111110111010
0000000001001000
0000000001011001
1111111110010001
1111111111010101
0000000001100111
1111111110001010
1111111111110101
1111111110000011
1111111111000001
0000000001001011
0000000000101000
1111111111000011
1111111110110111
0000000001000100
1111111110001001
1111111110001011
1111111110110111
0000000000000011
1111111111011110
1111111111111110
1111111111011010
1111111110111100
1111111110011011
1111111111111111
0000000001001000
1111111111111100
0000000000001111
0000000000001110
0000000001110010
0000000001001101
1111111111000111
0000000000001101
0000000001011110
1111111111111011
1111111111000000
1111111110111100
1111111110000010
0000000001100100
1111111110101101
1111111110101010
0000000000110010
0000000000001001
1111111111011011
1111111111000111
0000000001000000
0000000000010100
1111111111110010
1111111111100000
1111111110110101
1111111110100111
1111111111011110
0000000001011001
0000000001011000
1111111110010010
0000000001000000
1111111111011111
1111111111001001
0000000001001011
0000000001111100
1111111111011000
1111111111100111
1111111111100101
1111111111100010
0000000000001010
1111111111101111
1111111110110010
0000000001010001
0000000000010000
0000000000101100
0000000001000100
1111111110001011
0000000001110111
1111111110110101
1111111111110110
0000000001001011
0000000000011001
1111111110001110
0000000001100000
1111111110111101
1111111110110110
0000000000101001
1111111111101100
0000000001111101
1111111110010011
0000000000011100
0000000000101110
1111111110011101
0000000000101101
0000000001010100
0000000001000000
1111111111101011
1111111111011001
1111111110011010
0000000000011001
0000000001011001
0000000001001000
0000000000010001
0000000000000101
0000000000011110
1111111110100000
1111111111111000
1111111110101110
1111111111011010
0000000000101011
0000000000000010
1111111110010111
1111111110111100
0000000001001100
1111111111011100
