11111111111110100011001101011010
00000000000000011011110010111000
11111111111111011010111101100100
00000000000001011011111000010001
11111111111111010001111001100101
11111111111110100110101011011100
11111111111111100011000111011111
11111111111111010100011001001000
11111111111100101111010110110111
00000000000010010111111101000100
00000000000000000010100100001100
00000000000100010001100110110011
11111111111111110100000011000000
00000000000100001010010100011101
11111111111101111111001101010001
11111111111110111111111100101100
11111111111110111010000111011100
00000000000000000111000011110110
11111111111111110010101110011111
00000000000001001010001110111111
00000000000001011110101111111011
00000000000000001010101101101010
00000000000000001010001111011101
00000000000000100101100110001100
00000000000010001011010010001100
11111111111110100001101011010001
00000000000001011101001101010011
00000000000010110100110100010111
11111111111101100010111101110011
11111111111111111110011100011110
11111111111111011111100010000000
00000000000000010001100110100010
11111111111111010001001011100010
11111111111111101010001110000100
11111111111111001110101010111001
11111111111110110110001011000110
00000000000000111011011000101111
00000000000000100100010001100010
00000000000000010101100010011101
11111111111111110010111010101011
00000000000000011101010100010001
11111111111110110110000111000100
00000000000000111011011011011010
00000000000001111001001101010000
00000000000000100011000101100011
00000000000001100110011010010011
11111111111111001010001001100101
11111111111101101111101000101011
00000000000000000101000100010000
00000000000001001010011100110100
11111111111110111110111010111001
11111111111111101011000010101100
11111111111111101001001011100110
11111111111110000111111010100111
00000000000001100000111101000001
11111111111101001101011000111101
11111111111110100011000111100011
00000000000001001000011101010000
11111111111101000001011010010100
00000000000000010010111100010110
00000000000010110110011111010010
11111111111111110011111000111100
11111111111111011111011000000100
11111111111101111101100000010010
00000000000000111000100001000010
00000000000000100101001110110000
00000000000011110011101101011010
11111111111101100111111101010011
11111111111111110111100101011001
00000000000000000100111100010100
00000000000000101000010111100111
00000000000010010001111011000100
11111111111111001111000001110001
00000000000000101111100110101110
11111111111101001111000110110110
11111111111101111110011010010111
00000000000000111111110010110010
11111111111111110001011100110111
11111111111110000100101101011111
00000000000001000010101010000110
00000000000010101010100011100010
11111111111110011110111100001000
11111111111110110111001100011101
11111111111101111111010101010011
11111111111110010000111011101001
11111111111111100100110011110000
11111111111110110101111110001111
11111111111100111100000010111100
11111111111111011000101011100100
00000000000000100100010011101101
00000000000001000111010111000001
00000000000010101011101100110111
00000000000001001101000111011011
00000000000000110001110010000110
11111111111111110001011110011110
00000000000000101010011111101110
00000000000001010111000100000010
00000000000010001010001100000000
00000000000001011010011001101001
00000000000010100010100011101010
11111111111110101000001010010011
00000000000000101100001011011010
00000000000011111101101000001101
00000000000000010010110100101001
11111111111111010101011110001111
11111111111110011100001010001110
00000000000001100010011101011100
11111111111111000111000000111110
11111111111110011011000101110011
11111111111111111000001100010001
00000000000011010011110000101011
00000000000001110000001001000111
11111111111110010000110011101010
11111111111111000110100001001010
00000000000011011110000000000011
00000000000000000011100010100110
00000000000001111111000001011110
00000000000000111010101100101011
00000000000001101001011011101011
00000000000000000100001101101011
00000000000001110111111100101101
11111111111110000111110011100110
11111111111111010011011010111000
11111111111111100101100000101100
11111111111110101110111101110000
11111111111111111100111010010000
11111111111111101010111010100110
11111111111111110110001111101010
11111111111110000111110010110111
00000000000010101010000111001010
11111111111101110111101001100010
11111111111111000100011100110110
11111111111111111011111100111011
00000000000001011011101111000111
00000000000011010101001110110001
11111111111110010011101011011001
00000000000000100101100000010111
00000000000010000000101110011101
00000000000001110110010101101000
11111111111111000110011110101001
11111111111110011011111011101101
00000000000001100001111001100111
11111111111111000101100000010111
11111111111110001100100101010001
00000000000001110100101001100100
11111111111111000111111001011111
00000000000001001111010001110000
00000000000000001100001010110100
00000000000010101110100111011010
11111111111111110101100110110010
00000000000000010010011110010111
00000000000000110110001001100101
11111111111111100111011110010111
11111111111110101001111010101110
00000000000000001110110000001000
00000000000001001100110111000001
00000000000000100000000110111110
11111111111111101111101100010011
11111111111101110111110001101110
11111111111111001110001010011111
11111111111110000000010100001110
11111111111110001101100111111001
11111111111110101001010101010010
11111111111110101001111110011010
00000000000010101101000110000101
00000000000000100010000001001101
11111111111101011110100010001100
11111111111110101100101110101110
11111111111111101100000000100110
11111111111110110011000011001000
00000000000001101100111100101000
11111111111111100010010001100000
00000000000000100100101111111000
00000000000001000000011100110010
11111111111111010101000100100110
00000000000000010100010000010010
11111111111111110000001010100111
00000000000001011010011000010100
11111111111100101101101100010011
00000000000010010110101000001010
11111111111110111111111000100111
11111111111101011100000001111110
11111111111100100010000110100001
11111111111111100100101100101010
11111111111111101101111101111010
00000000000010100011110011000010
11111111111110100111101101110010
00000000000010001000001010110111
00000000000000001101111000111111
11111111111101000000011100010000
00000000000000010000111111010111
00000000000011000001000111000000
11111111111110101101011010010101
00000000000001000011000010111110
11111111111111100000000000001010
11111111111111101010101010010010
00000000000010101011011011111001
00000000000001101111011110001011
11111111111110101001111110001011
11111111111111111011011101000011
11111111111111111111000101001011
11111111111101001110011101101001
00000000000001111100101100100110
11111111111111100110000001001011
11111111111110111010100101011101
00000000000000100011000011111001
11111111111111101000000011100001
11111111111111101011011101111011
00000000000001010010100000001010
00000000000000100000101101010111
00000000000000110000010111000100
00000000000000111100100010101010
00000000000000100000000001010110
00000000000001101001101011001110
11111111111110101010111010010001
11111111111110011101100010111001
00000000000000101011110001011001
00000000000000111001011010011100
11111111111101011011111101101100
00000000000000000010000001100011
00000000000001011100101010011010
11111111111111000000111110110011
00000000000000110011001101010010
11111111111101101111010100010001
00000000000010010110100001100110
11111111111110001110001001000111
11111111111111011110100111011110
11111111111110101010110000110010
11111111111101010111101010011011
11111111111100111100110111010001
11111111111101101111001001110100
11111111111101100010110110111010
11111111111111011111011011111000
11111111111111001100001100100010
11111111111111001000100111000110
00000000000000101100100100110000
00000000000000110110011111101010
00000000000010110100101111000110
00000000000000100101111000000110
00000000000000100001001100001110
11111111111110101110110001011011
11111111111110101100010001100110
00000000000001010110101000001101
11111111111110111100001011111100
11111111111110001000011100001101
00000000000010011111101101001010
11111111111111111101111100111011
00000000000000000010100001011100
11111111111100010101100101000110
11111111111111001011010111011100
11111111111111101101100010001110
11111111111110010000111010101001
00000000000000100000001000100101
00000000000000100010000011001010
11111111111111001011010101100101
11111111111111100110011000111100
