11111111101011000001101111011011
11111111110010110000000101010111
00000000000011011110110101001111
11111111110100000010000011001100
00000000010100001011000011101111
11111111111010110111101111101000
11111111111010011101010001000000
00000000000000011001000100111110
00000000100000000000100000101101
00000000101000001101000100000101
11111111111101110100001101101101
00000000011011010111001101011110
00000000001100101010011111101101
11111111101101110010101111001100
00000000000010111011010011111000
00000000010010101110110101110000
11111111011110001110011000110101
11111111101001111010101011010001
00000000000001111110110101110101
11111111110010100100101000101011
00000000001110110101001001010101
11111111111010010010000101001111
00000000010000010011111010100010
00000000001000010000001011101010
11111111100111001000100011010001
00000000011010111000000000011101
00000000000001011011100101000011
00000000001011111011000011100101
11111111110001110000110110000101
00000000001010010001010000000011
00000000000011011001111101011110
11111111111011000111101110101110
00000000001101111000011011000011
11111111101110101000011011011100
11111111011100101011111111101000
11111111101000101100101110001000
00000000001111000111000100001011
00000000010011101111111101011100
00000000001010000011011111011000
00000000101010101110000100111110
11111111101000000010010110110001
00000000010010010110101010000100
11111111011100100111010111000100
11111111101100001100110011110100
11111111110100101100010101101101
11111111101011001001001011000000
11111111101001011001000101001000
11111111111001110111011010110010
11111111110100000001111111110100
11111111110000100110011110100101
00000000011001111010110110001011
11111111100111000110010001110011
11111111101010111100110100110111
00000000010110111111101000100011
11111111111101100110111011001001
11111111110110110011011101010000
00000000001000110011011101001100
11111111101110111011001011000101
11111111111001000101010110111001
11111111110010100100000100101001
00000000000101001101100111101001
11111111110011110111000101100111
00000000010100101100110101101011
00000000000111101001001010001000
11111111110100110011100000011111
11111111101101000010000111010110
11111111110111000111101111100100
00000000001011111100111011110110
11111111111000110110010111111100
00000000001010010010110101001011
00000000001100001110011001001111
00000000000101010110000111100100
00000000000111101011000111000101
00000000000000001001101101111110
11111111101110011011000100101110
00000000000010100101101000001000
00000000101111001001101110100000
11111111110010110100110010110001
11111111101100000000101010000111
00000000000010011110000011010110
11111111110111100101001010111101
00000000001101110000011110111000
00000000011001111111010100000111
11111111110011000110111001111010
00000000000101111100110001100100
00000000001011011010100000010001
00000000000111001100100010011101
00000000000101101100001100011110
11111111011000011001101100111111
11111111011100111010101101101000
00000000000100101100110100011011
11111111100100111111010100111110
11111111110000100101101111000000
00000000001000011100111010011011
11111111100110001111100001010001
11111111100110100100111010111110
11111111111101010101110000101001
11111111101010001101100010000011
11111111111111101100100101101110
00000000010111111001000110111110
00000000101000001010101100110011
00000000010100101001000000100101
00000000000011100110110011111001
00000000011010001101000111011000
11111111110000100110010110010101
11111111101000101011010101001101
11111111110111010111110100000110
11111111110000001111111111111010
11111111110101010110110010001011
00000000110011101000111000001111
11111111101001110011111010100111
00000000001001100001100101011100
00000000010000100001000100110001
00000000001010010111111100000010
11111111111110000100011110100110
11111111101000110101100001011111
00000000100000000010011001111101
11111111101010101011101110001111
11111111101111100111100110110011
00000000000011011100110010100101
00000000000011011011100010111011
00000000000110001000000101110100
11111111111110100111011100111000
11111111111010101110011101010101
00000000010110010101110111001011
00000000011000100000110010110011
00000000001110010011011000000011
11111111111111010000011011100111
00000000100011001011100111110001
00000000000110011011100001010011
11111111100101010100011100000101
00000000011011110000101100110011
00000000000110110000101100001110
11111111111111110110110000011010
11111111110000100101010101101011
00000000000000011110100000101010
11111111111101010001001001101111
11111111111111110010110101001111
00000000001100111011011011110001
11111111100001111111101000101111
00000000000000011011110011010110
11111111110000100010011010110000
00000000001001010110000011011011
11111111110010111000110101011000
00000000000111010110011011010001
11111111110001100010011111101010
00000000000111011110001101101000
11111111111001001100111011110001
11111111011101110101011001101111
11111111011100110010000011110000
00000000100010010000100111011100
11111111111000010011110111110001
00000000001101100100111101110101
11111111110010111010011000001100
11111111111100100011000111100100
11111111111101001000010011110111
00000000000011010010010001110011
11111111101100001001001000101010
11111111110110001110000000001000
00000000000110001011101110001111
00000000001010101110010010001111
11111111100000111111001011111001
11111111111110101000100001101101
00000000001001110001100010111101
00000000000001111111101100010110
11111111111111011111000101001000
11111111110011100111100101110100
11111111111000010111100000100010
00000000010110110001111110001001
00000000000111100001011100011101
00000000010100101111001110101101
00000000001110100001010000010011
00000000011111111100100111101110
00000000000000111010101010000110
00000000011101001000001110101110
11111111101110000110000001100010
11111111100101101100100010110111
11111111110011111000100101011000
00000000000011001110000011111010
00000000100111011000001101011010
11111111111101011110100111011110
00000000000000001011101110111100
00000000001000100000001100000100
00000000000010110100010111011000
00000000001001000111010001010101
00000000001010001111011010001000
00000000010110101000101110010000
00000000001001010101101111011000
11111111111101011000101011011010
00000000000111011010011101001100
11111111110010000000100101000110
11111111111010111110101010000110
11111111110101111111011000101110
11111111110001010000011001100111
11111111101100100101001100111110
11111111101000011111011111100010
00000000000011110100101111000111
11111111110000010010000110110010
00000000101110100001010101101110
11111111111000100001101010001010
11111111111111000010101010011010
00000000000101100001011111100011
11111111101101100110010111101010
11111111111010110100111010010010
00000000100101101011100111110001
00000000000111001111110111100000
11111111110111000111110100110010
11111111111100110010111001011110
11111111101111000000001101000101
00000000000110001111011001110000
11111111111011011001011100000110
11111111111110011000101111010111
11111111111100100011100010001001
00000000010010100110010101001101
00000000000010000101011011110001
00000000100011011001000100001010
00000000000101010011111101111101
11111111111010000101010000010110
11111111110101101010000010110000
11111111011101111111001110001011
11111111111010001011101011001001
11111111110010000000100110111001
11111111111101001000010010011101
11111111110111000100101000100000
00000000011010100100111101110110
11111111101101011101001000101011
00000000010001001110110011000000
00000000000110100101110001001101
11111111111100111011010010100001
00000000010111100000011100001001
11111111101011100001100110001010
00000000011100000010011111010111
00000000011010110001111110000100
11111111100100111011111100110001
00000000000010101001010100010100
11111111110111000110001010100111
11111111100110101100101001011001
11111111111011001101101111110011
11111111111001110000101000010110
00000000000101110111010111000101
00000000001111111110000000001100
11111111110010000000110010001000
00000000001010111010011001101100
11111111011001000110110100000010
11111111111001110010101100000010
00000000100111000111101010100100
11111111110011010010101110011010
00000000001111000011101010000111
00000000000110101101100111100110
00000000001000010101000111100010
00000000100110110001101110110100
00000000001110011011010101010000
11111111110010011111100010100100
11111111100010001110010111010010
00000000011010110011011010110110
11111111110001010010110100101111
