11111111000101011010000011111101
11111110101010110111101000101110
00000000010010110000011001110001
11111110001101011100000111011011
00000001101100101010001101011011
11111111100000010111100101010100
00000001000101011111111111010001
00000000101100111000110000100110
00000000001101010011110101110011
00000001111100000110000010000101
11111111011101001011110010010010
00000001000010001101100101101010
00000000111100100011110000001010
11111110011111100011100000010001
11111111110100100000011011100001
00000000011000000000010100100010
11111111010110000100010011100000
00000000100110110010011100111010
00000000010111001001101100010010
11111111111011110100001110000100
11111111000100101001111111110111
11111111001110000001101101001111
11111110111011001110101011010010
00000000000001000100011110000111
00000000011001010110010111100010
00000000100101111111110110011110
00000000010110011001100011010101
00000001001010001101000011010000
11111111110001000101011100101101
00000000000111001010001000111111
00000000000111110010111011110101
00000000101010000101001000010100
11111111110100010101111101101101
11111111011001000101000000110000
11111111101110000000111011100111
00000000010011010000110111010111
00000000101010111001001001000101
11111110110110010011101100001111
00000000010011011111001011111011
11111111111001011101100100100011
00000001101110000100000101010001
11111111101101001000110111110100
00000000010110000000101000110000
00000000001010110000100100100101
11111111110011100010010111111110
00000000100011011111111100110001
00000000001110101011100001101000
00000000000111010100001011010001
00000000101011100101101111110001
11111111111011110000010011011100
11111111011100111101010110000101
00000000000000101111000010001000
00000000110110000010111111010100
11111111111111010110010100110010
00000000001101100100001100110001
11111111101101110011011111101100
00000000110001101110011111110000
00000000110111111101101100101101
11111111101111100011001011010011
00000000001011001011010110101100
11111110110110001000011110011001
11111110101011111110101010010110
00000000001110001011011000110111
00000000011011010000111111101101
11111111010000111011000010010001
11111110111011111110110111101100
11111111011100101111011101001111
11111110010011100010101111011011
00000000001100111101000100101001
00000000110001000001100011011110
11111111110111000101001110111111
00000000111010111110100000000110
11111111000101100101101101011001
00000001001010110111100010011101
00000000010110100100101000010110
11111111011011001000110111000100
11111111011011110011100101101100
00000000011010100000010010111111
11111111011000011110100001010001
00000000001111011011011100110110
11111111010110110100100001111000
00000000001100010110100011101110
00000000110100011011100000010100
00000000101001101001100101010110
00000000000101001111101111110111
00000000100100110110110100110011
11111110011000001010100011011100
11111111011010110110011011100001
00000000101001110000010111010110
00000001000001110100110001110100
11111111011101100011001000011101
00000001011010100110011000100000
00000000011101001110011001001011
00000000100010001001111001111011
00000000011000010010101101100101
11111111100110010110000011100100
11111110011010010101011101000101
00000000101110011111111001111110
00000000111000010100011001110101
00000000100110111100011000101011
00000000001000111101011000100111
00000000101101110001110011000011
00000000100011100100000101011001
11111110100100000100101110100001
00000000101011100010101110010111
11111111101111101101111010100010
00000000110111111001101111100000
00000000001011001010011001111001
00000001001100100100110110110000
11111110111000111110111100011011
00000000110011100111011110011110
00000000111100101110110110001011
00000001011010101110110101001111
11111111111000101011111011101100
11111111011101011110111010110001
00000000011110110111011101000110
11111111110011111101111011000110
11111111101111010000011110001000
11111111111111000100001100111101
00000000110100000000101010101100
00000000011110101110100000001100
11111111111110000001110100110001
11111111001001010111000011101011
11111111110111101001011110001000
00000001001000011001000100110011
00000000000010100000011111110100
11111111011001110111011111110111
11111111111110101011101111100111
00000000101010011111011011111101
11111110100010100101101110010010
11111111110111101011101110011011
00000000001100110110010000100011
00000000000001010001011100111110
11111111011101110000001000100000
00000000000010111101010001110001
00000000001100010000101000110000
00000000010111101110001010101001
11111111101000000010011000100011
00000000111010010100000011110010
00000000100111001000110011101101
00000000100010011011010010110000
00000000100011111001000010011110
00000000110000011011000010000110
00000000000110010101100100000000
00000000010101101010111010110000
00000000000100100111100011101000
11111110110101011101100001100001
00000000011100111010110111000000
00000000001001010000000100101001
00000000010001000000010011110101
00000000010011000111010010001001
00000000000001101101000101110011
11111110111111100010101101010011
00000000010110110100000110010010
11111111100010111001000011111111
11111110011001011011010011110000
11111111111111001001001001010000
00000000000100001100110110000101
11111111001001111001111011001101
11111111111110101111101111000011
00000000111001110110100101000010
11111111111101101011100011101110
11111111111101100011101100010111
11111111010011001110000001100111
11111111000000111110101100110001
00000000001100010110100101110001
11111111101100010010010001101000
00000000111101111010011101101111
00000001000110011011110110010111
11111111110101010010011000011000
00000000110011110000111011111100
11111111110001110010101111010100
11111111100101101010101110111010
11111111111100110111001110010101
11111111101110001011100010001011
00000000101101001001011100010001
00000000100110100000111000110110
00000000100010011001010010011010
11111111011010111000010100011001
00000000011111110011000100000001
00000000110000011001110100101100
00000001111011100110100000001101
11111111000000100011001111000000
11111111010111000110010011110110
00000000001100011100000111001001
00000001101010010101010110010011
00000000101011100110110101010011
11111111010110001010010100001011
11111111111100111100100110110011
00000000010000010000111001001001
00000000000110100101011000000010
11111111101010101010100101001100
00000000001011011010010100010011
00000000001001001111110011011110
11111111101110111010111111100101
00000001000000100010011010111011
11111111101110011011010110001110
11111111001010000110010010100000
11111110010011000000111100010111
00000001001000100111011010011000
11111111111111001010110000100011
11111110111011110000000010001101
00000000110001100000101101100010
11111111001101110101111101101001
11111111111010000111010001111000
11111110111111100110111001011100
00000000100111011110100111010010
11111110110101010011010011001000
00000000010110010001010010101000
00000000011110111111100100011000
11111111111001000100010010001111
00000010110101111111110111011000
11111111111101011001001000010111
00000000111101011001111110011001
11111111010100010000111010100001
11111111001111010110000111010101
11111111001110010100000001101111
11111111011100101011010101011110
00000000100011100001011011101111
00000001001010101010000000111000
11111111101000000011110101011000
11111111001100001110111001011111
00000000010100111100011101000111
00000000111011111100100100101011
00000000111010010111110110110110
00000000110111111111000001101010
11111111001110000001110010001101
11111111000111000000011001101011
11111111100111010110100110000011
11111110001110001111100111000011
00000001011000101000100011011000
00000000011000010100001111010001
11111111111010000111111111111001
00000000001101010000011111110000
11111111111011011101111101001000
11111110100011100011110100100110
00000000010010001111011000011010
11111111111101001101111010001001
11111111101011010111101111101101
11111111001010110100110100000011
00000000011100110111101011110010
00000000001011111011101000110110
11111111101110111101001011111011
00000000000011110000101101001111
00000001100111000000011010000100
11111111110010011000101001000001
00000000000001110110001110100110
11111110110000100011110100001010
11111111111000011001100110010001
11111111111010001100100100111101
11111110011010010110011110101111
11111111001011011000000111110101
00000000001010111000001001011001
11111111000110000001101000111011
00000000110011110111101111110010
11111110111110001000101010101010
