1111110010111000
0000000010111101
1111111100111101
1111110101110000
1111111111110000
0000000000010101
1111110111001001
0000000110101100
0000001001111010
0000000100001000
0000000001101010
1111111101101110
0000000101001001
0000000011111000
1111110111010100
1111111110100001
0000010000101010
0000001000011101
0000001000001111
1111111011011111
0000000111111001
0000000010101110
0000001001101011
1111111011100100
0000010011001000
1111110011101111
0000000110110111
1111111100100100
0000000110011100
0000000111010111
0000000100110000
0000000000111100
1111110001111000
0000000010000101
0000000011111101
0000000101001010
0000000001110000
0000010100100001
1111111110011101
0000001100111010
0000001000010000
1111111011100110
1111101010100110
1111111110010110
1111111001010011
0000000100101110
0000001001010100
0000000110010011
1111110101101010
0000000100111101
1111111001101011
1111110111010111
0000000011000011
0000000011101000
1111111110011111
0000011000110010
1111111010011010
0000001100111111
0000000111100101
0000000010010000
0000001111001100
1111100100011111
1111111110001000
1111101101001100
1111111110100011
1111111100001100
1111110111101010
0000001100101101
0000010001001101
1111111100000101
1111111010000101
1111110101001000
1111111001111101
0000001010100101
0000000011100010
0000001011000001
1111110110100000
0000001101011011
1111111111110011
1111111010010000
1111111001101001
0000001001010100
0000000101110000
0000000010001010
0000010000101111
0000000010000100
0000000110011101
0000001101010000
0000000111000110
1111110100110011
0000000001111000
0000000100000111
1111110000110110
1111111101001110
1111111111101110
1111111111000010
1111110111101011
1111110110100000
1111110111001100
1111110000111111
0000000111111011
1111111111001011
1111110100001111
1111111101000000
0000000011011001
0000000011011001
1111111111111100
0000000011110101
0000000010100000
0000000010001011
1111110000111011
1111110110011010
0000000101000001
0000000110011000
1111110111011010
1111110010110010
0000000100111101
0000000101010100
1111111001100011
0000000000110000
0000000011001100
0000000010010111
0000000110110010
1111110111001011
0000001110110110
1111111111010100
0000000110101000
1111111101101100
0000000110101101
1111110100111111
0000000111001100
1111111010101000
0000000000111100
1111110100001101
1111111000101101
0000001100010110
0000000000100010
1111110001000001
1111111000011011
0000001101100001
0000010010110101
0000000100010111
1111111001001110
0000000101110000
0000001000011001
1111111110111111
1111111011001011
1111111111001111
1111111110111011
1111110010101111
0000000101110011
0000000000010110
0000001000000100
0000001010101010
0000001000100000
1111110011100000
1111110101000011
1111110011011000
1111111001011100
0000000110100111
0000001110011011
0000000111010011
1111111011111010
1111111010001010
1111111100111110
1111111100011111
0000000000111001
1111111110011110
1111110001111010
1111111010000111
1111111101000001
0000001001110111
0000000000110001
0000011010010101
1111110101111110
0000000100011110
0000000101011011
1111110111100011
0000001010110111
1111111100011111
0000000011101011
1111111110110001
0000001101011111
1111110100100010
0000000010111100
0000001010101010
1111110010111100
1111110101001000
1111111101111111
0000001001110000
1111111101000000
1111110101101111
0000000011110111
1111111010100101
0000000100111010
1111110110011011
1111111111100011
1111111110010111
1111110100000010
1111110000100111
1111111110100110
0000000011110100
0000000110110110
1111110000010111
0000000100100001
1111111111100011
0000000000100010
1111111001111001
0000000000101011
1111110011101100
0000000001010100
1111111101100100
0000001010011001
1111110100110101
0000000010011000
0000001001110001
1111111000011010
1111110110000110
0000001110100101
0000000000101111
1111111101010001
0000000010100110
1111110011110111
0000000110010000
1111101110101111
1111111111101001
1111111011110100
0000000000111111
0000010101010011
0000001000011101
1111111100101010
0000000110110001
0000000000000100
0000000001011000
0000001100110010
1111111001010011
1111111111111101
1111101110110101
1111110110110100
1111111101001111
0000000010111011
0000001110101110
1111110101001010
0000010010000110
0000000110001001
1111111111001111
1111111010101000
0000000100001111
0000001000000000
1111111101011110
0000001100000111
0000000110001011
0000000010001001
1111110111110010
0000000001100111
1111110100001000
