00000000000101010100011011011011
00000000000100110001000110011101
00000000000101101001100001011110
00000000000001001011010100001100
11111111111101010010001011010001
00000000000111111100111110101001
11111111111101010000111111111010
11111111111110011001110011100000
00000000000000010001011101011001
11111111110010000001011111000011
11111111110010011100001101100010
11111111111111010100011011011100
11111111111101110100001011000100
00000000001000000100001001011010
11111111110100111110110001011000
11111111111111001001011010111100
11111111111011101000101001110011
00000000000001011001101100111101
11111111110101110110100101000101
11111111111100000011101011111011
11111111111011000101111111011001
00000000000110011011010010100001
11111111110110000110001111110010
00000000000101100001011000011110
11111111111011011110010000100111
11111111111011110101101101010111
11111111111101100101110101100100
00000000000100101110101001001010
00000000000010010111011001011111
00000000000000111100111000000111
00000000000000000111011011001000
00000000001011000100110111010010
11111111110100110011110000110111
11111111111111001010111001111101
00000000001001100111110010000100
00000000000000101111100100001010
11111111110111101101110001011110
00000000000101101011001101101000
00000000000100110100000100100001
11111111110111001101111110100101
00000000000011100011000100100111
11111111110110010111100000000101
00000000000011111010101110011111
11111111111110110111001111101011
00000000001011010011100000011101
00000000000000111101011000111001
00000000000000001001101110100110
00000000001110000111110010000100
00000000000010010010011110111011
11111111111000010011111010101101
11111111111000111101011111011101
11111111111101110110000111100101
00000000000111111011001000101100
00000000000001101001101000000010
11111111111011001111100111011100
00000000000010110011101010010010
11111111111111110111010110001110
00000000001001111000001010101000
11111111110111011011011001000110
11111111111011100011111001000010
11111111111001011111011111001111
00000000001000000110000101111011
00000000000100110101000010110001
00000000001010000011110010011101
00000000000000010010000100101101
00000000000000000101010001100001
00000000001000110101100110110011
11111111111111000011000001010101
11111111111100111101001011110011
11111111111101010000011011110111
11111111111000001010011100011111
00000000000001010000110010110011
11111111111100001111100100001010
00000000000010001000100110100000
00000000000100101100010101101100
11111111111101110111110011101110
11111111111010101111110100100011
11111111111111000001101000110111
11111111111010111000011110010100
00000000001000100100000110001000
11111111111010010101001100100110
11111111111000010111001111101100
11111111110111010011001001100010
11111111111111110001010000010010
11111111110110011101101001010010
11111111111011000110110011110100
11111111111111111001011100100100
11111111111110110100101000100100
11111111111111110100000111110010
00000000001010110011100000011100
00000000000001111100101110010010
00000000000111000100100000010110
00000000000111111010000111001010
00000000000110001100001000100110
00000000000101111010110001110001
00000000000101101001001010100011
11111111111101111111100101110010
00000000001000111000010100011110
00000000000100110111110011101101
11111111111101001100011111100011
11111111111100010110110101011101
11111111110100001100011001000001
11111111110111101111110100100011
00000000000100000100011001110011
11111111110111111111001000010100
11111111111110011100000110111110
00000000000110000100100011101000
00000000000111110001011010000110
00000000000000001100111101000010
11111111110110000000011101100000
00000000001000000111000100001100
11111111111011001011011110000000
00000000001000100111011110011001
11111111111111001111101101111111
00000000001001111101101111110100
00000000000000010011001001100010
11111111110110100111101110110100
00000000000001101111010011110000
00000000000000110001010110110101
11111111111001111000011011000011
11111111111101100011011011100011
00000000000101100100101010001011
11111111111111011001010010101111
11111111111010001001101000000011
11111111111110100011000111111001
11111111110011101100111101000011
00000000001011000010111010110000
00000000000010111000110001111110
00000000000010011110100100010000
11111111111100111101111001101010
00000000000111011011110000000001
00000000000101111110010111001001
00000000000110100011000001010100
00000000000001100001101100001000
11111111111111110001000011001011
11111111111111100000010000011001
00000000000000111111001110110101
11111111111111100010101010011001
00000000001010000101111100000110
00000000000100000001101000110110
00000000000010000000101010100111
11111111111001100011100101011001
00000000000101110111011001011111
11111111111101000101100001111001
00000000000010010100011000001011
11111111110100010001100111001111
11111111111011001100011000111111
00000000001000100010101101101001
00000000000000001001001101110101
00000000001001011011010101110011
00000000001100110011101101100100
00000000000011000111100100111110
00000000000000100110010011000011
00000000000110001100011111100001
00000000000011010110111100000001
11111111110101011111001110110111
00000000000000111100000110111110
11111111110100000010110000111110
11111111110111111111011000101100
00000000000010001101101110001100
00000000001100111100100001001011
11111111111100111101010101100111
00000000000011111010100111111100
00000000001011011011011111101000
11111111111101100000010110111100
11111111110111010000111111111010
00000000000010011000101000001001
00000000000100010011000110001111
00000000000110101010111001111101
11111111111011101001111000011011
11111111111101000001001011011001
11111111111110001111001101001101
11111111111100100010010110101111
11111111111010010101010110011101
11111111111001101111101101111110
00000000000111001111101010101100
11111111111111110000010101010011
00000000000110100001111001001111
11111111111010101010011100011110
00000000000101110000100101101010
11111111110101110010010001110110
11111111111101000111111000101000
00000000000111001100110110011111
00000000000111110011001001100001
11111111111000111111001110110111
11111111111111000001001011010111
11111111111100010011001100110011
00000000000101011011111001110101
00000000000010010000010010000001
11111111111001111100000110111111
11111111110110101111111011000110
00000000000010011011010101110100
00000000000011110010111001001001
11111111111000110111100110100111
00000000000011110101101101010111
00000000000100011000100001100101
11111111110101000110110011110101
00000000000011111110011010011011
11111111111101110001100111001111
00000000000000111011001111010001
11111111111101100000010110111101
11111111111110000101010100110011
11111111111111000010001001101000
00000000000100111110111110011100
00000000001000101011010100001010
00000000000010011000100100111000
11111111110110010000100010011011
00000000000001010101011100111111
11111111111011011010100100101011
11111111111111011110001010000011
11111111111111010110010001011010
11111111110011010000001110110000
11111111111010011011101100110000
00000000001000000010000110010110
00000000000100111101100010101100
11111111111101110100000111110010
11111111111000111011001000101101
11111111110111000110110011110101
11111111111111011100111011011001
00000000001011101110001110111011
11111111111010110101001111111000
00000000001000101100001000100110
00000000000001101000110011100110
11111111111110100011011000010010
00000000000010010001001001101101
00000000000000100101101000011101
00000000000011111110100100010000
00000000001001100100000010110110
00000000001001101100111101000001
11111111111101101000110110111001
00000000001010101110110010111111
00000000000010100110111010010111
00000000000011010010101100000010
00000000001001000101111111011000
11111111111011001000111101011110
00000000000001111101011111011100
11111111111111101101101110001100
00000000000011100111000100001100
00000000000001110000001000001101
00000000001101011110001101010011
00000000001000010110000001000001
11111111111101011100100100011101
11111111111000011001011100100101
11111111111111100100111010100101
00000000000100100111001110000001
11111111111111011110100111100001
00000000000101111111001000010010
11111111111101101111100100001010
00000000000001011010000011111001
11111111110100101110001000011011
00000000000001101000011111111101
11111111110111001000110000010111
11111111111110100111110101010111
00000000001110011000011110010011
00000000000010111101110011000110
00000000001100011100010100000100
