11111111111111010110000011011111
00000000000000100101011101100101
00000000000000000101110110100111
11111111111111011011100101011101
00000000000000011001010100111101
00000000000000110110101110011011
11111111111111111011101000011011
00000000000001010000011010000001
00000000000001000000000000111101
00000000000000000000110010001101
11111111111111110100111010011111
11111111111111110101101111100001
00000000000000101000010110000011
11111111111111101000000100001011
00000000000000000110111101101011
11111111111111100101100000010001
11111111111110111100011100110011
11111111111111110110001111011001
00000000000000000110110011111011
00000000000000010100100010011101
11111111111111100011100001101101
00000000000000010111110110001000
00000000000000000010110111001000
00000000000000110101101111111111
11111111111111001110010001001001
00000000000000010000100000010111
00000000000000100000100111110011
11111111111111110100100100001101
00000000000000011101101010010011
11111111111111100101001001010100
00000000000000000011111101101110
11111111111111010011110101011011
00000000000000011011110000110100
11111111111111110011101110110100
11111111111111010010110010001011
11111111111111010110010010011000
11111111111111101001011000101011
11111111111111011000011001101001
11111111111110111001001110101111
00000000000000100100101101010000
11111111111111010000000100110000
00000000000001010101011100001000
00000000000000010100000110111111
00000000000000100111011111111010
00000000000000011110001110000101
11111111111111010001011001011111
11111111111110111001011000000011
11111111111111011101010000111010
11111111111111101000000100000011
00000000000000001111010010010000
00000000000000101001011001101000
11111111111111100111101110000110
00000000000000001010011011010001
11111111111111100101001000001100
11111111111111110010001010101110
11111111111111011101110110010101
00000000000000010001100110111001
11111111111111101101100110111110
11111111111111111011001101111000
00000000000000101101111111010000
11111111111111010101111001101011
11111111111111001110001100101010
00000000000000110011110101101010
11111111111111100001001101000001
11111111111111101001100111000010
00000000000000000100111100000100
11111111111111011000000001010100
11111111111111100101101001100010
00000000000001011110010011011000
00000000000000000101001011001111
11111111111111011100110110001010
00000000000000000000010011011011
00000000000000001111010110001110
00000000000000001010101100001110
00000000000000011000011100110000
00000000000000010100100101101100
11111111111111110001101100110000
00000000000000010111111001111011
11111111111111101110001111100010
11111111111111011010000100010011
11111111111111101111001010010111
11111111111111001101001001110101
11111111111111001100011111000100
00000000000000010000111001110011
11111111111111100001001011011101
11111111111111001001111110101110
00000000000000001001011001100101
11111111111110111001110101011100
11111111111110110000110011011111
00000000000000001011011000011101
00000000000000001110011001000100
00000000000000010110110101000001
00000000000000001011111001100001
11111111111111100110001101111000
00000000000000110011111110100111
00000000000000011011100001000000
11111111111111111010101011100011
00000000000000010011000011001000
11111111111111010011100111110110
00000000000001100111010001101010
11111111111111101010101101100100
11111111111111100000100000000010
11111111111111101110101111101001
11111111111111010001010110100111
11111111111111100001001100101101
00000000000000110100011010001100
00000000000000000111001101101000
00000000000000101001010010000010
00000000000001010000010101011000
00000000000000101111110010001110
11111111111111111111011001001101
11111111111111010100011011001001
00000000000000100001000010000110
11111111111111111110100000110010
00000000000000011100100110101101
00000000000000110001000001100011
00000000000000101100101011101101
11111111111111110101011100111010
11111111111111111101001110111001
00000000000000001100010000001010
00000000000000000110110111001000
00000000000000000110111001100110
11111111111111011111001111001111
11111111111111010101010111100001
00000000000001000000000100110001
11111111111111010001101011000110
11111111111111111100001000111111
00000000000000010100101111111010
00000000000001000110010111001010
11111111111111100101110001101010
00000000000000010010101100000101
11111111111111100001000100111000
00000000000000000000110111100111
11111111111111000011111111010101
00000000000000011001110110110111
11111111111111111111100101101000
11111111111111111010100010010100
00000000000000000000111101000010
11111111111111100001001010101101
11111111111111111111101101100010
00000000000000001101100001010111
00000000000000110111100001011011
11111111111111001010101000111011
00000000000000001100110111000010
00000000000000001110101100110110
00000000000000001100010111011001
11111111111111101100011100000000
11111111111111011000010010010011
00000000000000000110100100100010
11111111111111111010010000101100
11111111111111111001000110001111
11111111111111100101110100110001
00000000000000011011001001111010
11111111111111110000100111110001
00000000000001000100100001001110
11111111111110111001100100001001
11111111111110111011101010110110
11111111111111110010011001111010
00000000000000001110111100011011
11111111111111100011000101000011
00000000000000010101011100100100
11111111111111011100001100000001
00000000000000111010010000011000
00000000000000000001110101010001
00000000000000111111111001001101
00000000000000011101000010011111
00000000000000101001011110011011
00000000000000001111000010110100
00000000000000101101100011111010
11111111111111110000101111000011
11111111111111100111001111001110
11111111111111111110111110001011
00000000000000000011111111011001
00000000000000010011100011000101
11111111111111111101010001000011
11111111111111000001111110100000
11111111111111001011011001001001
11111111111111110101111101001111
11111111111111100100000001001010
00000000000000001110110100110111
11111111111111111010110001010100
00000000000000010010101011100000
00000000000000101101010001011010
00000000000000010100011110110000
00000000000000010010001110100011
00000000000000000101101000101101
00000000000000010001000000011000
00000000000000000000010111011011
11111111111111111010111101010000
00000000000001001110110000011100
00000000000000000110011100001100
11111111111111100111110001001110
11111111111111101011111110110101
11111111111111111001100101110001
11111111111111101110001111101001
00000000000000001110011111101011
00000000000001001011010111001100
11111111111111110101101001110100
11111111111111011011001100110010
00000000000000001011000010111110
11111111111111111110000101010011
11111111111111110001000011010101
00000000000001011101000010100111
11111111111111100000100100010011
00000000000000000111101001011100
11111111111111010000111111000010
11111111111111011001001010011110
11111111111111100010100000111000
11111111111111011110000000011001
11111111111111101110001001001111
11111111111111111010010000100000
11111111111111100100000001001100
11111111111111110100010111010111
11111111111110111011111110100000
11111111111111101011010100001000
11111111111111110100001010011111
00000000000000001010100111111101
00000000000001000110110010000101
00000000000000000100001010111010
00000000000000100101001100100110
11111111111111111001000111000111
11111111111111111100110001100100
11111111111111110110110010111010
00000000000000001100011110110111
00000000000000110101001001111010
00000000000000001011101110101010
11111111111111110011100001001100
11111111111111110110011011011111
11111111111111001101011001010101
11111111111111101110001100010110
00000000000000000101010010100111
11111111111111001001110111111010
00000000000000110101100011111010
00000000000000111000000100111100
11111111111111010111000011001110
00000000000000101111000000111011
11111111111111111001110110100111
00000000000000001101001011100100
00000000000000100010011101100111
11111111111111011010111010010100
00000000000000011111111100000000
11111111111111100010100101101001
00000000000000110101100110110010
11111111111111000100011100110010
11111111111111100100111111000110
00000000000000011100110110100110
00000000000001001101100011010110
00000000000000010000101010001100
00000000000000001101011011001100
00000000000000011110000111010101
11111111111111100110100101100000
00000000000001001110001111010010
11111111111111110011100101011010
11111111111110110010001101101100
00000000000000010101110100110100
11111111111111100100000001101000
