00000000000011001111101010101100
11111111111010100110010011000011
00000000000010010100010100111000
00000000000001010000001011011110
11111111111001101001100100110001
00000000000100010000111111111001
11111111111100010110000100010100
00000000000110000001000001100010
00000000000011011101111100111011
11111111111011011010100111111100
11111111111101110100000111110011
11111111111110010011110100001000
00000000000001100011000100100110
00000000000100110100000111110010
11111111111101010100100101010010
00000000000001100110110011110100
11111111111101111101111100111100
00000000000100000000011101011111
11111111111100110011000110010000
11111111111001000100010011010001
00000000000100110001110100010100
11111111111011101111011101100110
00000000000100000110011100111000
00000000000010111001011100100100
11111111111101010001001101000001
11111111111000100111000100001101
00000000000110000010111010110001
00000000000100010001111110001010
11111111111101101101111110100101
00000000000110010001100000101010
11111111111100100111100100111110
11111111111010110110100101000101
11111111111110100111000100001101
11111111111100001100110110011111
11111111111111011111101111101000
11111111111010011011110000000010
11111111111000000001101111011011
00000000000000001110111001100011
11111111111000011011101100110000
11111111111110101110101100011101
11111111111111101000001111100101
00000000000101100110000010101010
00000000000110010111100011010100
11111111111011000111110010000101
11111111111101000101111111011001
11111111111111101001111011101101
00000000000001111111011000101011
00000000000000010111111010010000
11111111111101111110101010110100
11111111111110000100011001110100
00000000000001010111010010111100
00000000000100101111000000000110
11111111111011001000110011101000
11111111111111101100111001110001
00000000000001110110111000101110
00000000000100000000101101111000
00000000000001100110100110101101
00000000000100101101100111101000
00000000000111101000001001000000
11111111111111010110010111111110
00000000000100010110011110100000
00000000000000100111111000101000
11111111111000010100000001001111
11111111111001011011101100110000
11111111111011101111101101111111
00000000000011110010100101011110
11111111111001111101110011000111
11111111111101111110011101101101
11111111111111101001111110111111
11111111111000101010001100000110
00000000000001101101010111001111
11111111111011010100000001001111
11111111111101011000010111110001
11111111111011100100100110111011
00000000000101001100101111111011
00000000000000101011000011110010
00000000000001000110110011110100
00000000000000110101100110110011
11111111111111101010100011000010
00000000000100100010101010011001
11111111111101010010000100101110
00000000000010011101011100001010
11111111111001111011101001011111
11111111111101111001110110110011
11111111111110010101100000010001
11111111111111111001110000001111
11111111111111110111000010100100
00000000000010110111101101001010
00000000000000011111000001101111
11111111111000001010100011000010
00000000000110101101101010111001
00000000000111011111001110110110
11111111111100010101110000101001
11111111111010100110001111110010
00000000000100101111101010101100
00000000000010101100011100010000
00000000000100010001011101011000
00000000000001110110000100010011
00000000000010011001011001010010
00000000000101100111001010110000
11111111111000101000111101011101
11111111111111110100010100111001
11111111111001001111110111110100
11111111111001001001100001100000
11111111111101010010010101000111
11111111111101010001010000010011
11111111111010101101011101110100
00000000000001000000011101011111
11111111111101001111100000111000
11111111111011101100001000100111
11111111111010100101000100011010
11111111111001111100110100110110
11111111111011011111100010100001
00000000000110011000110101001111
11111111111111000001000100110101
11111111111101011111001000010011
00000000000110100110101001111110
00000000000000111011011111101001
11111111111010101011100111110110
11111111111101100000111010111111
11111111111001010111001111101011
11111111111100001010010101111011
11111111111100000100000010111000
00000000000001100110000101111100
00000000000111011111101001000011
11111111111100011010101110100000
11111111111010001111001101001110
00000000000100110011110111011001
11111111111111010100111000111100
11111111111101111001001000111011
11111111111101101010101100110111
11111111111111000111010001010100
11111111111000011011000010001010
11111111111000100001010001111011
11111111111110001110011111010110
11111111111011110001100011111101
00000000000101111010000111001010
00000000000101101011111110110001
00000000000011100000000000000000
11111111111110000110000010101011
00000000000100100001101111011010
11111111111100011001011001010011
11111111111110111011011111101010
00000000000101100101110010010001
00000000000010101001100100110000
11111111111000000101001110001111
11111111111000110101001001010101
00000000000100000000010000011000
00000000000111111000101110101100
11111111111001101000001100010011
00000000000010001011011110000000
11111111111001110011001001100010
00000000000100101011000111000100
11111111111111010010111001001001
11111111111101101110101111101110
11111111111000101000010110001000
00000000000011000100001001011010
11111111111010110000101111100001
11111111111111101001001101110101
11111111111101100111001110000010
00000000000000101001010111101001
11111111111110000010010110101111
00000000000000110111111101100010
11111111111101110101100011100011
11111111111000001110101111101110
11111111111101110110100101000101
00000000000111010001001101000000
00000000000111110111000010100011
11111111111011101010001000110100
11111111111001000000000011010010
00000000000110010010100101011110
00000000000101000110101001111110
00000000000100011010010000111111
11111111111011111100011010101000
11111111111100000000000110100100
00000000000001111010110101000010
00000000000011001000011001011001
11111111111101001000111101011101
00000000000111110010000100101101
00000000000111110011010000000100
11111111111110001011111000001110
00000000000000111111011111001110
11111111111010110101011001101101
11111111111110101011000011110011
00000000000000001100110110011110
00000000000010100010101101101010
00000000000000011010111110110111
00000000000100101110010010001110
00000000000011010111100000000011
11111111111101101000000010011110
11111111111100101111111110011000
11111111111011101101100100010111
11111111111111100110111010011000
00000000000011000110100110101101
11111111111111011110001101010100
11111111111011010001000110011101
11111111111110110110110101011101
11111111111011011000111011110100
00000000000011110010111111101100
00000000000010100111110101010110
11111111111100011100100100011110
00000000000100100000001101000110
11111111111101111011010101110100
11111111111110111010010100010010
11111111111110110100101000100100
00000000000101111011111101001000
11111111111001111111001000010011
00000000000001000100001111111110
00000000000110001100110110011110
00000000000101101101011010100001
11111111111010011010000000101000
11111111111100100011011011100011
11111111111011110011100000011110
00000000000100100011000111111000
00000000000011100000001101000110
00000000000101010011110000110110
00000000000110001101010000101100
11111111111100000000101101111001
11111111111101000101100001111010
11111111111011010010011000011000
00000000000011000101110010010001
00000000000011001000010110000111
11111111111000010000110010110011
00000000000000001011111000001101
11111111111010000000010110111101
11111111111010010100000001001111
00000000000010101001010111101001
00000000000101100001100010010011
00000000000110001001110101001001
11111111111101100111001010110001
00000000000100000010100111000111
00000000000001110010101111010011
00000000000010000100111010100100
00000000000110011100001010001111
00000000000101101000101001110001
00000000000010110000100010011010
00000000000100000101101000011100
11111111111000000100101101011110
00000000000011101110001011101011
11111111111111011100011010101000
00000000000011101111100100001001
11111111111111011111111001011101
11111111111100111101001000100000
11111111111110011011111001110111
11111111111001101010110110101100
00000000000111001011000111000100
11111111111000110111010010111101
11111111111001100100000010111000
11111111111110111011110000000010
11111111111011011000111111000110
11111111111000110010001011010001
11111111111000110101001111111000
11111111111110001000011100101100
00000000000100000011001110011100
00000000000101000111110010000100
11111111111101101111011010010101
