11111111001011001010100011000111
11111110110011011011010000001101
11111111110111101111111011100000
11111110010000011111011011011011
00000000111100110011101001000010
00000000001000101100100100011001
00000000011110010010100111001000
00000000110011111011101000010110
11111111101001011100110001100110
00000001100011011110110010010001
11111111111001111000001101010100
00000000001110101011001110010111
00000000001100001011101010111011
11111111011101000001111001101000
11111111100110011111011110011001
00000000010011101101111000101100
11111111010110011100011010101100
00000000011001100100100000010100
00000000100101110010100110010011
00000000010010101110111001101101
11111111100100111100110111110111
11111111111001011100010001000001
11111110101001101100100111010111
11111111101101111101011100110100
00000000100001100011010111011100
00000000110011111010010100001001
11111111111001111110010101111001
00000001010010011001101101111000
00000000000111001001111010111100
00000000010100101010000001011101
00000000010000000010110100101101
00000000001000001101100101111100
11111111000111010101101101011001
00000000000011110010011101010111
00000000010011001010101010101110
00000000011101000110101000000001
00000000011001111011010000110110
11111111110010000010101111101001
00000000011011100001101000101010
11111111001110110001001001100010
00000001001100110011011001110100
11111111101110011011011001001011
00000000100110111101001100001000
00000000001010111101011111001111
00000000100000000011100111010111
11111111101110001111011100100110
00000000100001001001100000000011
00000000100010000001100000101110
00000001000011001010010010100000
11111111111010001110000111100100
11111111011101001110001000011011
00000000001111110011001111100111
00000000010101000000011101001101
11111111110111010011011001011101
00000000000110010100001100110111
00000000010000111010000101001100
00000000101000001110011111111110
00000000011010111111110000101111
11111111011100011101000111011111
00000000000001011010011010011010
11111111111111010000110001100110
11111111010111001111100101000101
11111111110100000001011100010111
00000000001100111110010111101010
11111111111010001111100000110110
11111111110101111110001111110111
00000000011010100110000011001011
11111111111100101001100111001001
00000000111011110010010011100011
11111111011011101000111110101111
00000000011010111011001010100110
00000000001001100101111010100101
00000000001100110001001100011111
00000000000010101101010101100101
11111111100101101100011110000111
00000000010101001110011110001011
00000000010011011010010100000011
11111111001010111110010111101001
11111111011101010011010111110010
00000000011001010100111100000001
00000000010100010010010001110010
11111111011001010111000111100100
11111111000011011000011101111111
00000000001000011110110000110010
00000000001010010100111101100100
00000000001111111000111110011011
11111111111111101010001001010110
00000000001110000010010000011100
00000000001101011101000101001111
11111111110011110011010110110000
11111111010000101110100001110010
11111111111100000101110111011101
00000000011111110010110011110110
11111111000011100100000001100001
11111111011100011011010011111011
11111111011001101101111011000100
11111111011110100001110110000010
11111111111011111000010011101011
11111111111111001011010100011011
11111111110100101111111000010001
11111111000011010001101110010001
00000000010000101110011101011101
00000000000111100011111001011000
11111111010010110111100011111011
00000000011100100001100010111001
00000000110101010101010101111011
00000000011010100100010111111111
00000000001000001110110110101101
00000001000011100001000010101101
00000000001001000001001010011011
00000000010111001110001000001010
00000000100101001110010001110011
11111111100110001010011001010010
11111111101000111010110010010010
11111111111111010101001000101011
00000000110101111011011111001100
11111111011010000000100000011000
00000000101100111010111010000101
00000000001110110000010111101000
00000000101010111000101111010100
11111111100111111100100111101101
11111111010100110000110101101000
11111111101000101100111011000000
11111111110000110011010100001011
00000001000101111000101111011010
00000000110011101111100111011111
11111111011111000101110100100101
11111111110001100111000100100000
00000000011010111100111000001000
11111111010101111010110000111000
11111111110011010011010111000000
00000000100110101100010101101111
11111111110111110110011001100110
11111111010011111011001101100000
11111111001010111111000111000100
00000000101010011100000001100100
00000000001011011100011101100110
11111111010001111001001101011000
00000000110101111010011000101010
11111111111010011111011000101011
00000000001110010001010010010100
11111111110001101111111101111101
00000000101011111100110100101100
11111111011101110100011011100100
00000000010101111110000110101100
00000000010001110011100100000000
11111111010111010000111001111000
00000001101001011101010111001100
00000000000011010100100110100000
00000000100111001101001001000111
11111111110011101100000110010101
11111111101000100001100110100100
11111111000110111011010111100001
11111111111001101111101101111000
00000000000011001101001111110111
11111111110010000010101010010100
11111111110011100110011111010100
11111111101000001101110111110010
11111111101111011011001100001010
00000000011101010110001001110111
00000000111010000111001101111100
00000000011010110101010010101100
11111111100101110010101111010010
11111111001101000111001101101001
11111111010100001010101001011010
11111111001101010011000110011010
00000000100010011101011010100000
00000000101011000111010110100000
00000000100000010001111011001000
00000000000001010001011100000100
00000000010111100111011100100010
11111111001010101011010001111101
11111111111011111101000011101010
11111111111101000010100100001111
11111111101100110001101000111100
11111111111011111111001000001010
00000000100001101100010010010100
00000000010111001010011101101000
11111111100100111010110000001010
00000000010001110001111000101000
00000001001011101101000111011000
00000000110110111111100100100111
11111111100001001100101110110011
11111111000011110101000100000000
00000000000010011010110110101101
00000000110010010000111101101000
11111111100010111110101010000001
11111111010000110001001110000000
00000000000011111010011000000110
11111111101011001001010001000010
00000000011101001110100011111010
11111111010100011001100111111011
00000000001111100010100011110101
11111111001111011010101000010100
00000000000110000100001111111111
11111111011110001010001001100110
00000000001000010110100000100000
00000000011000100011010100101111
00000000110000011111101000000010
11111111110101110100001000011010
00000000100000000010110101110000
00000000010000110101000101100010
11111111101001111110001100111110
11111111111100101100011001111010
00000000011000011101011011100111
00000001001000110011100101110001
11111111010100010111001101110110
00000000111011010000001000100010
00000000001011010110010001100011
11111111110100101111110101111111
11111111011010111100001001011001
11111110111011000011100010110110
11111111111111100110101111101111
11111111100100101001110100001010
00000000110011000011000001001010
00000000000101000101010000111101
00000000000000000101000000111110
00000000011011001011100111010011
11111111110010101001001011101010
00000000100010000010100110000111
00000001010101111110001000101100
00000000000011111010010111110100
11111111101111000100001011001011
11111111111110010111100110001100
11111110111010011100100111110001
00000000011001000111010001011010
11111111001111000010011110100101
00000000001010101001111100101110
11111111110100111001010100100010
00000000000010110100111110001111
00000000111010011111111001001000
11111111010111111000111011111100
11111111100001100111111101101010
00000000100111100111010000011010
00000000001001100100001011010110
11111111010011000000000111010110
00000000101010000001011110111001
11111111110110011001000111101101
00000000000101000101010110101100
11111111001110100010001011111010
00000000000010101000000101101111
11111111100111101111110110101111
00000000000010010001111011111011
11111111111110000110010100111110
00000000010010011100010111101011
11111111000001000110010100000000
00000000011100000010110100100100
00000000001111010100010011010101
11111111111010011010110101010000
11111111000010011110000000111101
11111111010000001101111010101010
11111111111001100100100001110001
11111111111110010001011011111000
11111111011001111000011000101110
00000000010011111110100011011011
11111111101011000001101011010000
