11111111110110111011100110001101
11111111011100111011111100101101
11111111110010100100100111101101
11111111111100001100111000010100
00000000011001010111010010001000
11111111111110000111010000011101
11111111000101001101010011000110
11111111110100000100001101011000
00000000000110110001000011110101
11111111010100011001100101111101
00000000110010100110001001101110
11111111110000101001110101010110
00000000011010000011010001101101
11111111111011101001010111000011
00000000100111001110110001100011
00000000000100001111011111111001
11111111100101011101111100111010
11111111110111111100011011100111
00000000100111011110100100100010
00000000010111101001100111101010
11111111101111100010110001010101
00000000010000000011100100110000
00000000100111011110010000011010
11111111010100100100010010111000
11111111111100101100101000011011
00000000000001011011110001101110
00000001000100110010101101110001
00000000010100000111001111100001
11111111111000111000110000110011
00000000010110001011101100100111
00000000001010010001000110100011
00000000011101000110100101010100
00000000001010000011111001000101
00000000001111000001100001000101
11111111110100010000000100001111
00000000001100000011101001101010
11111111101100000001010101010000
00000001011000001000010110101101
00000000101001001001000111001000
11111111110001011111101100111100
00000000011000111111011110011111
11111111011000011010010000011001
11111111110000000011011010010000
11111111111011111000010101111110
11111111111011111010111000101001
11111111110010011001000001101011
11111111101010011110110000000001
11111111101001011111111101000001
00000000011001001010110011011000
00000000000000101001101110100111
11111111000000111110101001100110
00000000111110111100011000100000
00000000001100111101011100100111
00000000100100000000010010101110
11111111010100011010101110011000
00000000110001111000111101000000
11111110111111100110000110111101
00000000011001100101000110011100
00000000000010110111110011011101
11111111101010111001111001111011
11111111110010010111101110000011
11111111110000111101011110100011
00000000110011101010110011111001
00000000010000010000011011101110
11111111011010101011000011110100
00000000011101101110101110101110
00000000000101100001001100101111
00000000000001110010001100011010
11111111001000101110000100101101
11111111101011001011110001110100
00000000101110010100000001100010
11111111010000010001111000111001
00000000111110111000011010011001
00000000110011110101110100101110
11111111110100010101111101010111
00000001000000110101010010111100
00000000111010000001100011000010
11111111100000010011000111010000
00000001000000010111101110010000
11111111101010011100001110011010
11111111101011001011100111110110
00000000110100110110111111100110
00000000011110110011110100111010
11111111011101001011011011011111
11111111010010010000100011001101
11111111000011110111000000101010
00000000010100000011111110010011
00000000001110100000000100100011
11111111110001100011000100101111
11111111110101100101100100100100
00000000101100000010110101100010
11111111111000100001110001111011
11111111100011001011000110110110
11111111111011010100011011001110
11111111111011001101110010101010
00000000100011110010100001000001
00000000101101000000010000010100
11111111010101000010010011010110
11111111011010100101100100100001
11111111110100011000100001111000
00000000000101001110000111111011
11111111000110100110111110001100
11111111111001111001001100001110
00000000011101001100100100001011
00000000101111110100001110110011
00000000010111110011000110110000
11111111111010111111000110111011
00000000000100101100101110011110
11111111110111100100011110011110
00000001001000111111101010101110
11111111111011001010100101000010
11111111111101101100001110010110
11111111000100110100111111100110
11111111101000110100010110011110
11111111111110110001010011110010
00000000101111011011001011000011
00000000000010100111000100100011
00000001011010100110000110001110
00000000101010111111000110001101
00000000001000100100110001010001
11111111011110110000011000011001
11111111011101001001011001010110
11111111110100111110011100010000
11111111101011100000110011111111
11111111101000011111100011111010
00000000110101111110010101011100
11111110111100101101101100110100
11111111111110010110001000101111
11111111001101010011010000001011
00000000101001111000000010001100
11111111110111000101010000110111
11111111011000100111111001000110
00000000001011100000011011100010
00000000000110010001010100010100
11111111100101010011111111101010
00000000011011110010100111101001
11111111000000111000101101110111
11111111111001110011011111100000
11111111001000000000110100011011
11111111111110111011110011010110
11111111010010000101001011100000
00000000010100101101000010111110
11111111100001000101000110001000
00000000000001101010011110000110
11111111100111101111000000000111
00000000001101010111001011110100
11111111111110101111001000100111
00000000111101010010111111001001
00000000010110110011111000101001
00000000000011101101100100101010
00000000001101011000111010000100
11111111011111110011110110010000
11111111110010110111000111001000
11111111000011111001010101001111
11111110110011011010111010000010
11111111010111101110000011101100
00000000000001001100000110010001
11111111010101001011110001001000
11111111100001111111001001111011
11111111000110111100001011001010
00000000000101101101011101110011
11111111001111010111101001001100
11111111101010101111101101011101
11111111101100001010110001101000
00000000011111001100010100101010
00000000010011101110001001011000
11111111011010101011011010101100
11111111111000110101010000101101
00000000000100110011111011100101
11111111110100111011001001001100
11111111101111010110000110101001
00000000010111110100011110101000
00000000110011101010001101001110
00000000010010001011011000100110
00000000011111111010001101010000
11111111111010001001101010100100
00000000110001110010011110110111
11111111011110000000110001001100
11111111101011011000111111110101
00000000100001001111011010000101
11111111010101101000010001011011
11111111101011000111111100010110
00000000111100110000100100011110
11111111110011110010111111001110
00000000001001001001011001101000
11111111100011110010001001110101
00000000011111110011010001011010
00000000110010110011010010100010
00000000101001110110010001111001
11111111101011110001110100010000
11111111010101111010011001010101
00000000111011010010100110100000
11111111110110100110001001001110
11111111000110110111100000100000
11111111101111000110011010011100
00000000110100000000000011100100
00000000000110010011111111101011
11111111000110011011010010101000
00000000100000111100111001111100
11111111000010111000110110110111
11111111010010101101111110100111
00000000010000001101010010110010
00000000110010100011000100110111
00000001011100010111000110100100
11111111111111101011000111100100
11111111110010000000010101011101
00000000111100001110001010111111
11111111111010111101011000110011
11111111110100001110100101111010
11111111111000011001101000001011
11111111110010101011111000110000
11111111010011110101110100101111
00000000000111011001010000101010
11111111110110100000100000111110
00000000001000010110001100110111
00000000011001011100110011010101
11111111110111111110010100011101
00000000010101001001011100001010
11111111100010010010000011101111
11111110011100000111101110010100
11111111111010101010101011110001
00000000011011101101011011100110
11111111011011111101110111010100
11111111100001011100010110010100
11111111111111101111010111000110
11111111100100000010111110100000
00000000010011000011101100000110
00000000000111110000001111110000
11111111101010001110101000100001
00000001000001101101011111110010
11111111011001001000100011000010
00000000000101100111010011000111
00000000011100101101111000000001
00000000000101011110100011111110
00000000100101000001111001111001
00000000010010101000100100100010
00000000000001010001101000010010
11111111111000101001110110100111
00000000000101111111010011011001
00000000010101100000111111011111
00000000001001011100100001001110
11111111110101111101110110101101
11111111110010111101001001100110
00000000010100111110000010010101
11111111101010011101100000011010
00000000011100100000100000011100
11111111101111001101010011110011
00000001001101011101000101111101
00000000001100101101011001111111
11111111111010011101100101000110
00000001011100101011010100111001
11111111111100100001100100111110
11111111010011100111001101101001
11111111111011111111110111111010
11111111100011110100010110011100
00000000011010110101000001001010
