00000000000000001010000101100001
11111111111111111111011100011110
00000000000000000000010111010110
11111111111111111100101010100000
11111111111111110011111110101011
00000000000000001001111001110110
00000000000000000110110111111010
00000000000000000010110110110010
11111111111111111101000010010111
11111111111111110110100110000000
11111111111111110010101100011101
11111111111111111010111000101111
11111111111111111010100110011010
00000000000000000110010010001110
00000000000000000111110111001100
00000000000000000101110010100101
11111111111111110010010010111101
00000000000000000000100001111001
11111111111111111110011000001011
11111111111111111011100101101100
11111111111111111001111010100101
00000000000000000010010100110010
11111111111111110110011011010000
00000000000000001100011000101011
11111111111111110111010011111110
00000000000000000110110010110010
00000000000000001010100111101000
11111111111111110000000001111101
00000000000000001001101111100000
11111111111111111000000000011011
00000000000000000011001000000101
11111111111111110110001000001101
00000000000000000101001111001001
00000000000000001000000100101101
11111111111111111010001101101000
11111111111111111001000101001111
11111111111111111101011001000000
11111111111111110100110001010111
11111111111111110000100011001111
00000000000000000111010101110011
00000000000000000001100001010001
00000000000000001001100100100011
11111111111111110001100100011110
00000000000000000010011101110011
00000000000000001001100100110000
11111111111111110010111010001011
11111111111111111000010111000011
00000000000000000100000101110101
00000000000000000101111000010100
11111111111111111011100100010000
11111111111111111001110001011110
00000000000000001011000011111001
00000000000000001100010000111001
11111111111111110110110111101110
11111111111111110110001101011011
00000000000000000011010100110010
00000000000000000011010100010001
11111111111111110100111110111000
00000000000000001110000110001111
00000000000000000011100001011000
00000000000000000001100101100101
11111111111111111100001100011001
11111111111111110010010000000101
00000000000000001101000000010011
00000000000000000110110100110101
00000000000000001101011010000111
00000000000000000111111000101000
00000000000000001000001110001110
00000000000000001010010111010110
00000000000000001111010110000111
00000000000000000010000100010011
00000000000000001101100010100111
11111111111111110001111010010001
00000000000000000011101111000110
11111111111111110111000100011010
11111111111111110010100110100001
11111111111111110110110011101000
00000000000000000000011011000010
00000000000000001010010000111001
11111111111111110111111110011000
11111111111111110001110000101001
00000000000000001110000111100100
00000000000000000010100100001001
00000000000000000100000001001000
00000000000000000010110001111110
11111111111111111011010000011001
00000000000000001101110101111101
11111111111111111101000110011101
00000000000000000010010100011110
11111111111111111000110110001011
00000000000000001001000001001110
00000000000000001011001011001010
11111111111111110010111111010011
00000000000000000001101111000110
11111111111111111001100010111011
11111111111111111000110001010001
11111111111111111011101010110100
11111111111111111111010001010100
11111111111111111001011011010000
11111111111111111110101100110111
11111111111111111100000010000100
00000000000000000110101011101110
11111111111111111011110100001111
00000000000000001101010101101101
11111111111111111011100111101001
00000000000000001111111011010010
11111111111111111110101110000110
00000000000000000010110001101010
11111111111111111110000011010010
00000000000000001111000000000000
11111111111111111010101001110010
00000000000000000011101110101100
11111111111111110100001000001101
00000000000000000010111100111011
00000000000000000011011100100100
11111111111111110111100110000000
00000000000000001110010001100000
00000000000000000000111111011000
00000000000000000011010010100010
00000000000000001111001110010101
00000000000000001011001100010010
11111111111111111010001101000111
00000000000000001011100011111100
00000000000000000000001100001011
00000000000000001110111000110101
11111111111111111001001011010001
00000000000000001101111011101100
00000000000000001111011010000111
00000000000000000000100011010100
00000000000000000101100000101010
00000000000000000000001100110011
00000000000000001010111011010010
11111111111111110101101000110111
00000000000000001111111111001011
11111111111111110101000111010010
00000000000000000001101011100001
11111111111111111010001110111101
00000000000000001110000010110000
00000000000000000001111101111100
11111111111111111011111100011011
00000000000000001001111110100100
11111111111111111001001110011101
00000000000000001001010111110000
00000000000000001010111001011100
00000000000000001110001111111110
00000000000000000001011100100100
11111111111111111010000110111110
11111111111111111111011011000011
00000000000000001101001011100100
00000000000000001011000001000001
11111111111111111001100011000010
11111111111111111010001100101101
11111111111111111111101000100100
11111111111111111010011001110100
11111111111111110101000000101000
00000000000000000001110100010100
11111111111111110101111111001100
11111111111111111001111110000100
11111111111111110111111110110010
00000000000000001100101011111011
11111111111111110101010101001101
00000000000000000101000001010101
11111111111111111111101100110000
11111111111111110001001000011010
11111111111111110010000010100100
00000000000000000110001111010111
00000000000000001000001010011100
00000000000000001100000100000110
11111111111111110100101010101101
11111111111111110110101101111001
11111111111111111011010110110110
11111111111111110010011001100111
00000000000000000110010001100000
11111111111111111000101010011010
11111111111111110100111000011100
00000000000000000101001000100110
11111111111111110101110000000010
00000000000000001000011101000101
11111111111111111011101110001100
00000000000000000110010010101111
00000000000000001010010110000111
00000000000000000010001101000000
00000000000000001010001100011111
11111111111111111100000110101010
00000000000000000001011010100001
00000000000000001100111001010110
00000000000000000001101101111110
11111111111111110010001001001000
11111111111111110001011001011010
00000000000000001000010100001011
00000000000000001010110110001010
11111111111111110000001111011000
00000000000000000100011110001101
00000000000000000001011101011000
00000000000000001001110010100101
11111111111111111111011101001100
00000000000000001000111000001101
11111111111111111000011111001001
00000000000000000111101011010100
11111111111111111010011010100010
11111111111111111001110010111010
11111111111111110010101001101100
11111111111111110111100001111010
00000000000000001100000110000010
11111111111111111011000111011000
11111111111111110100111001110111
00000000000000001001101010100110
11111111111111111000110100100010
11111111111111110011000111110011
00000000000000000110000100010011
00000000000000000110110100100001
11111111111111111010000011001100
00000000000000000101000011011110
11111111111111111110110001111111
11111111111111111110010011001010
11111111111111111001001011011111
11111111111111111000110111001101
00000000000000001101110111101101
11111111111111111010111000001110
11111111111111110011101110101101
11111111111111111011110111100001
11111111111111110110110111010011
00000000000000000101001111101010
00000000000000001010011111101111
11111111111111111110110111001101
00000000000000000000010000110010
11111111111111110110111001101010
11111111111111111100110110011000
00000000000000001101100110000101
11111111111111111110000101100010
11111111111111110011101011011011
00000000000000001000000111111000
11111111111111110000100100111000
00000000000000001001101100001000
00000000000000000001000100110100
00000000000000000111001001011010
11111111111111111000011011111110
11111111111111111111011001101101
00000000000000000110111000111011
00000000000000001000001111100100
11111111111111110101110101010111
00000000000000001000110001110111
11111111111111110010010100011001
11111111111111110100111011000110
11111111111111110010000001111101
11111111111111110010100000000100
00000000000000001100111011100110
11111111111111110100010001111011
11111111111111110101000010100100
11111111111111110101110001101011
00000000000000000000010001100111
00000000000000000011000101011011
11111111111111111010110001010001
11111111111111110100010100100110
00000000000000001000001010001000
11111111111111110110100001100000
