11111111111110010110010101001001
00000000000000011001111100011101
11111111111111101000000010110101
11111111111110101110011111000101
11111111111111111110100001011110
00000000000000000010110100110110
11111111111110111000111010001110
00000000000000110101111111011011
00000000000001010000011100111110
00000000000000100001110100001000
00000000000000001100101000011000
11111111111111101110100110101100
00000000000000101010000000110011
00000000000000011111100110011101
11111111111110111010011100010010
11111111111111110100011100010100
00000000000010000110010100100000
00000000000001000100000010111011
00000000000001000010010010111001
11111111111111011100011110110100
00000000000001000000000111001100
00000000000000010101111011000000
00000000000001001101111010010011
11111111111111011100110110101111
00000000000010011001100110101110
11111111111110011101100010010101
00000000000000110111000011000101
11111111111111100100000101100100
00000000000000110011110110011101
00000000000000111010001101001100
00000000000000100110010101010101
00000000000000000111100100111101
11111111111110001110101011011011
00000000000000010000011011001001
00000000000000100000000101101001
00000000000000101001010100000001
00000000000000001110010011110110
00000000000010100100110011011010
11111111111111110011111100101110
00000000000001100111110100100001
00000000000001000011000110100110
11111111111111011011111011000100
11111111111101010011011001011010
11111111111111110010111000100100
11111111111111001001111001110001
00000000000000100101011101111001
00000000000001001011100101000100
00000000000000110011001000111110
11111111111110101100111000111000
00000000000000100111011011110011
11111111111111001100111111000101
11111111111110111010000011111010
00000000000000011000010111010100
00000000000000011101010110011100
11111111111111110011110000011101
00000000000011000110111101011001
11111111111111010010111001100010
00000000000001100111110111010011
00000000000000111100100101000101
00000000000000010001011001010000
00000000000001111001100111001011
11111111111100100000111111001010
11111111111111101111100000000001
11111111111101100110110110110101
11111111111111110100011111000010
11111111111111100011001101111011
11111111111110111110001011100011
00000000000001100111011111000001
00000000000010001011110001001111
11111111111111100001100110101001
11111111111111010001011001110010
11111111111110101001100001100101
11111111111111001111111001001101
00000000000001010101110001010011
00000000000000011101100000101001
00000000000001011001110101101011
11111111111110110100000001000100
00000000000001101011110110111010
11111111111111111110101010001111
11111111111111010001110101100010
11111111111111001100010100110110
00000000000001001010011100100010
00000000000000101110011100001111
00000000000000010010000010010000
00000000000010000111000010000100
00000000000000010000011101101010
00000000000000110101001000101100
00000000000001101010101010101010
00000000000000111001000011000011
11111111111110100101101111001000
00000000000000001111000111101110
00000000000000100001011100110110
11111111111110000110100011011101
11111111111111101001011111110011
11111111111111111110010110101001
11111111111111110111110000100111
11111111111110111101000011110000
11111111111110110011011011111011
11111111111110111000110110101011
11111111111110000111001000000101
00000000000000111111100101100101
11111111111111111000001011101101
11111111111110100001011101000100
11111111111111100111100110110001
00000000000000011010111010001111
00000000000000011100000100100011
11111111111111111111010100010011
00000000000000011111110010000001
00000000000000010100101001111000
00000000000000010000111101100110
11111111111110000110110001000011
11111111111110110010101110010100
00000000000000101000100100100000
00000000000000110010101001111000
11111111111110111010100110110011
11111111111110010101111100110010
00000000000000100110110100101000
00000000000000101010011100111100
11111111111111001011011001000110
00000000000000000101011010101100
00000000000000011001100010011001
00000000000000010011001011111010
00000000000000110101110110010110
11111111111110110111010010001110
00000000000001110111100100100111
11111111111111111001010011011001
00000000000000110101001100001101
11111111111111101011111100101111
00000000000000110101111001101101
11111111111110101000110011000100
00000000000000111010011100111100
11111111111111010110010010011110
00000000000000000111110100101110
11111111111110100001100010011110
11111111111111000101111101010101
00000000000001100100100001110010
00000000000000000100110101101101
11111111111110000111101010001101
11111111111111000010011001011110
00000000000001101101111111000101
00000000000010010111011010000110
00000000000000100011100011101011
11111111111111001001110101011110
00000000000000101110010100110001
00000000000001000011011000011110
11111111111111110111111110001111
11111111111111011001100011010110
11111111111111111010000101001000
11111111111111110111111010000101
11111111111110010101010110101001
00000000000000101111001110110110
00000000000000000010100010110101
00000000000001000000100011110010
00000000000001010110001110101010
00000000000001000100111010110011
11111111111110011010100110010001
11111111111110101000010101010100
11111111111110011010001110100000
11111111111111001011100101011110
00000000000000110101101010011110
00000000000001110100001110010011
00000000000000111010101100010110
11111111111111011110110110011110
11111111111111010000011011111000
11111111111111100111001101000000
11111111111111100100000101011110
00000000000000000110011010100011
11111111111111110011011111011100
11111111111110001101110110110111
11111111111111010001000011001011
11111111111111100111011000001100
00000000000001001110011010001101
00000000000000000110101001001100
00000000000011010010111010101111
11111111111110101110100001111010
00000000000000100011100111000111
00000000000000101011111100001010
11111111111110111011101000111111
00000000000001010111111001100100
11111111111111100011100000000010
00000000000000011100100010101001
11111111111111110100111110101111
00000000000001101011110100101110
11111111111110100011110010011101
00000000000000010110111000111010
00000000000001010100111000000110
11111111111110010101111110010111
11111111111110100111110110100101
11111111111111101111101100110110
00000000000001001101011000110010
11111111111111100110100110110110
11111111111110101011110101110010
00000000000000011111000101001000
11111111111111010110000011001010
00000000000000100111111100110101
11111111111110110011110000101111
11111111111111111100100010110101
11111111111111110011001000111110
11111111111110100000011011111000
11111111111110000100111100000001
11111111111111110100110101101010
00000000000000011110101000011101
00000000000000111000000101011110
11111111111110000010001100110010
00000000000000100100111000100111
11111111111111111100001100100110
00000000000000000100100011110111
11111111111111001111011111101101
00000000000000000101010000010000
11111111111110011101000100011110
00000000000000001010001010110001
11111111111111101100110010001100
00000000000001010100000010111000
11111111111110100110000000001010
00000000000000010011001000010100
00000000000001001111001110011010
11111111111111000011001111111011
11111111111110101111110001111100
00000000000001110100111111110000
00000000000000000101101001111001
11111111111111101001110010101001
00000000000000010101010011111001
11111111111110011110000100111101
00000000000000110010001110100011
11111111111101110100111001010100
11111111111111111100101111001110
11111111111111011110001000011001
00000000000000000111110100101001
00000000000010101011111100000111
00000000000001000100000101001100
11111111111111100101010010011010
00000000000000110110010111001101
00000000000000000000001001111110
00000000000000001010001010100011
00000000000001100110000101111100
11111111111111001001010011110000
11111111111111111111001101011011
11111111111101110110000111001000
11111111111110110101111000010111
11111111111111101001011111101101
00000000000000010110101100101000
00000000000001110110100000001110
11111111111110101000101110100101
00000000000010010001100111001000
00000000000000110000111010111100
11111111111111111001011000111100
11111111111111010011111100100010
00000000000000100001101010010000
00000000000001000000000101101001
11111111111111101011101000011000
00000000000001100000111111010010
00000000000000110001000110110001
00000000000000010000101101000101
11111111111110111100010100100001
00000000000000001100001000101101
11111111111110011110110101100011
