11111111111101111011001011111111
00000000000010101111011101100100
00000000000111001101111011010001
00000000000101000110000101111100
11111111111101100010010000001011
11111111111111100011111001000100
00000000000000111110100111100001
11111111111100010111100000000100
00000000000100000110011100111000
11111111111011111111111100110000
11111111111101001000100110100000
11111111111010101000110011101000
00000000000000010110001010110111
11111111111011101100110110011111
00000000000001110111111101100011
11111111111001111111101100010111
00000000000011001101000000010100
00000000000001100000001001110110
00000000001111100011000111110110
11111111111001100111100001101100
11111111111010101001101000000100
11111111111110011100101110010011
11111111111011111011001000101110
00000000001001011111011111001111
00000000001000101000100110100000
11111111110011110111011100110011
11111111111011010000000001101010
11111111111101010100101111000111
11111111111010000110011100111000
11111111110110010100111000111101
00000000001001100000011101011110
00000000001100011110100111100001
11111111110000100101011011010111
00000000000000011110111110011101
11111111110011100011110010011111
00000000000001111110000110110001
11111111101111000011010001101111
00000000001000100101000001001000
11111111110001011101101100100011
11111111110111000000111110010010
00000000000110110011100011101111
11111111111110000001110101111101
00000000010010100001100010010001
11111111111011110000010101010011
11111111111001100110001100100000
11111111101110110101001001010110
11111111111001000011001011001100
00000000001011000100101101011110
00000000000110000000010000011000
11111111111111001011001101100111
00000000000110001001010111101000
11111111111010110111011100110001
00000000000010110101011001101100
11111111110101111000000100001000
00000000000000001011000111000100
11111111111011011111011000101100
00000000000000001101101010111001
11111111111111000101111100001001
00000000000001010110100101000101
11111111110110001101101110001101
00000000001101010110000100010010
11111111110110111011001100000000
00000000000010000101111000110100
00000000001011000010110000111010
11111111111001011011000010001010
00000000000101100110100110101100
00000000000110100011000001010100
00000000000011101100101001010110
00000000000101011010011110000101
11111111111101010110111111010011
11111111111011010100111100001111
11111111111111111000100100111001
11111111101001111101111001101100
00000000000110000110001001001101
00000000000001010010100101011110
00000000000001110101110000101001
00000000000101000111100100111110
11111111110001000001001000000111
00000000001101001011001010010100
00000000000010001001010100010111
00000000000100011100001101100010
11111111111010100010110111100001
11111111111110001100000010000100
11111111111010000101011000000101
00000000001101000000010000010111
00000000000001010000010101010010
00000000001100010100000001001101
11111111111110111001100110011010
00000000000111100100110111010010
00000000000001001111101010101101
11111111111111111110011101101100
00000000001111011000101011011001
11111111111100111001010110000000
00000000000001100011111111100110
00000000010011001100111001101110
00000000001100110110010100101100
00000000000000000100111010100101
00000000000000111011000101011011
11111111110101000100001100101111
11111111111011010100000100100001
11111111111100111111011000101011
11111111101101000110000101111101
00000000000010011010011010110101
11111111110101001110111001100011
00000000001001101001001010100010
11111111111010001001100100110010
00000000000010111010101011001110
00000000001001101100011000111110
11111111110000001111001101001110
00000000001011110110000001000001
00000000001001001001010111101000
00000000000010001100111101000001
11111111110101111001110000010001
11111111111110000101111100000110
00000000000010100110011001100111
11111111111110101100001111001010
11111111111100010010101111010100
00000000001100000110110111000100
11111111111111101100001111001010
11111111111111110111101101001010
11111111111001010001010000010010
00000000000010110100101111000110
11111111111111010000010101010100
11111111110111000111111111001100
11111111110100011010111110111001
11111111111000101011010000111001
11111111110101101101000000010101
11111111111110011100110100110101
11111111111111011000101000001001
11111111110110101110110010111111
11111111110001100110001111110011
00000000000010101011100001010001
11111111110110011001010010110000
11111111111110101010001111010111
11111111111110000101000111101100
11111111111101101010110000001001
00000000000100010000100010011001
00000000000111111001100110011010
11111111110011111010110101000011
00000000001111111100111000000110
00000000000001000110000101111101
00000000000011110101111010011110
11111111110101010100101000100101
11111111111110000000111110010000
00000000000001001011011010101110
11111111101101001011111011100010
00000000000001000001110010101100
11111111111110010001010110110100
00000000000010010011100000011110
00000000001001011110011010011010
11111111111010111000101011011010
00000000001111101101100100010110
11111111101100000101001110010001
00000000000011110100111100001101
00000000000011101110101100011011
11111111101110110011011001111011
11111111111110110011101010010011
11111111111111111101001011110010
00000000001111101101000000010001
00000000000100011000101000001010
11111111110000110101011001101110
00000000000000010100001110010110
00000000001000101111001001111010
00000000010111001011001101100110
11111111111011100000111110010010
11111111111110000101001110001111
00000000000000101001111110111110
00000000000110101011011010101101
11111111111001110100100010000000
00000000000011111000000100000110
11111111110000111010110001110010
00000000000000010110011110100000
00000000001000110010111111101100
11111111110111011101101111110111
11111111111000100101110010010010
00000000000101111101000101001111
00000000000111111111000101000000
00000000000010101010001000110101
11111111111010011011111101001010
00000000001110001011010100001001
11111111101111010111001100011010
11111111111011111010010111100100
00000000000111110101100000010000
00000000001011100000101010100110
11111111111110110000110110000100
00000000000110000100110111010100
00000000000011010011101010010010
00000000010000111100101010111110
11111111111110101101111000000010
00000000000000100100100000010110
11111111111101110001111110001010
00000000000101011011001011111110
11111111111001100111000000111100
11111111111101110000011000100101
00000000000111000111111000101000
00000000000110100001011011101111
00000000000011011010000000101000
11111111111011101010111101001110
11111111101101001000100110100010
11111111111101100001011011110000
11111111110111100001110101111111
11111111110000000101000100011101
00000000000010100111010001010011
11111111111010000011000001010101
00000000001000011101010010010100
11111111111011100110010011000011
00000000010000100111001110000000
11111111111110010001001101000001
11111111111011111111001110110111
00000000001100111101100010101101
11111111111100110100011110101111
11111111110011011110000000001101
00000000000011111111011011111100
11111111111000001101000000010101
11111111111100011101011100001010
11111111110011110101001111111001
11111111111111101011111011100000
11111111111111111011011001000111
11111111111010001000101101000100
00000000010111010111110110111101
11111111111110100000000000000000
11111111111100000100101101011110
00000000001001101001010100011000
11111111111001001011011110000010
11111111111111101110011100000100
00000000000000101011011010101111
00000000000011110110101110111010
00000000010011110011100000011011
00000000000001100001111111110011
11111111110100010000101111100011
00000000001011101001011110001101
11111111111001011110100100010001
00000000000100111000000100000110
00000000000111001000110011100110
11111111110100100001001000000110
00000000001011000011110010011110
11111111111001110000101111100010
11111111110111110111011100110010
00000000001011100110110011110100
00000000010010110011110111011000
00000000001100110011100000011100
11111111111100011100000110111110
00000000000001100101101011101110
11111111111011100101111100001000
11111111111011101011111110110000
00000000000000101101100001000100
00000000001000111001011111110100
11111111111100001100101001011000
11111111111011010110000111100100
00000000000110000110100110101100
11111111110101100101011110101010
11111111110100011000000111011010
11111111110111101100100010110101
11111111110001010001110100010101
11111111110010100101111111011001
00000000001010001010011100011101
