1111111111011111
0000000001010000
0000000001110011
0000000000101010
1111111111011001
1111111111000111
0000000000001111
1111111111111001
0000000001000010
1111111110101100
1111111111010010
1111111111000000
0000000000000101
1111111110100001
0000000000011111
1111111110111011
0000000000110100
1111111110011010
0000000011110110
0000000000011000
1111111110101100
0000000010011000
1111111111000000
1111111111101000
0000000010001001
1111111111010110
1111111110110101
1111111101000000
1111111110100001
0000000011000110
0000000010010111
1111111101100110
1111111100001011
0000000000011111
1111111100111001
0000000000001001
1111111011110010
1111111101110010
1111111100011000
0000000010001000
0000000001101101
1111111110111100
0000000100100111
1111111111100000
1111111110011010
0000000010110001
1111111110010010
1111111011101111
0000000001011111
1111111110101110
0000000001100001
1111111111110010
0000000000101101
1111111110111001
0000000000000011
1111111101011111
0000000000000100
1111111101100100
0000000000010110
1111111111110010
0000000011010100
0000000010110000
0000000000100000
1111111101110000
1111111110011000
0000000000111011
0000000001101000
0000000001011001
0000000001010101
1111111111111111
1111111110110101
1111111111010111
1111111010100001
0000000000011101
0000000000010101
0000000001100001
0000000001010010
0000000000100001
0000000011010000
1111111100010001
0000000001001000
1111111110100010
1111111111100100
1111111110101010
0000000011001111
1111111111101111
0000000011000011
0000000000010011
0000000001111001
0000000011110100
1111111111111111
0000000000010100
1111111111001111
0000000011001110
0000000100110001
0000000000011010
0000000000000001
1111111110110101
1111111101010011
0000000000001111
1111111111001111
1111111101010100
0000000000100111
1111111011010010
0000000010011001
0000000010011010
0000000000101101
1111111110100100
1111111100000100
0000000000100010
0000000010010010
0000000010111100
1111111101100000
1111111111101100
0000000000101010
1111111111100010
1111111111000101
1111111111111101
1111111111111011
0000000010111111
1111111110010101
1111111101110011
1111111111110101
0000000000101011
1111111101000111
1111111111101000
1111111101011101
1111111110001100
1111111111110110
0000000000101011
1111111100011100
1111111101101011
1111111101101000
1111111111011100
1111111111100010
1111111111101010
0000000001000100
0000000011111110
1111111101000000
0000000001111110
0000000000010011
1111111111100000
1111111101010111
0000000000111110
0000000000010011
1111111111100100
0000000000001111
1111111011010110
0000000000100110
0000000011111010
1111111110101110
0000000010010110
1111111011000011
1111111011101110
0000000000111011
0000000000111100
1111111111101101
0000000001000110
0000000011111001
0000000000000000
1111111100001111
0000000101110001
0000000010001011
0000000000000101
1111111110111001
0000000001101001
0000000000001001
1111111111100001
1111111110011110
0000000000000101
1111111100010000
0000000000111101
0000000010001011
0000000001011111
1111111110001011
1111111101111011
0000000001111111
0000000011100001
1111111110101001
0000000000101011
1111111011111001
0000000010110111
0000000001111101
1111111110111111
1111111111101101
0000000100001101
0000000000110101
0000000001100001
1111111111101011
0000000001010101
1111111111011101
0000000000000111
1111111110011011
0000000001100111
0000000001110001
1111111111011101
0000000000110110
1111111111011000
1111111011010100
1111111110111010
1111111101111010
1111111110100001
0000000000101010
1111111100000011
0000000010000110
1111111111100100
0000000100001000
1111111110111010
1111111111000000
1111111100111000
1111111111001110
0000000011001110
0000000000111111
1111111100111110
1111111111000111
1111111110000100
1111111111111011
0000000101110100
1111111110100011
1111111111111110
1111111111101000
1111111110010100
0000000010011010
1111111111000010
1111111111111100
0000000100111011
0000000000111110
0000000000001011
0000000000011000
1111111110011001
0000000010111010
1111111101000101
0000000001001100
0000000010110000
1111111101001010
0000000001110010
1111111110011110
0000000100101011
0000000010111000
1111111101111111
0000000011001011
1111111110111001
0000000000011001
1111111111000111
1111111110111011
1111111111000011
0000000010001011
0000000000001011
1111111110110101
1111111101001000
1111111101011011
0000000001100000
1111111101111011
0000000010100001
1111111100101011
1111111100010101
