00000000000010100100100011101000
00000000000011111010110001110000
11111111111011010110101000010111
11111111111100001000110011100111
11111111111111010000011011110110
11111111111101111101101100100100
11111111111110010001110100010101
00000000001010010001000110011011
00000000000000100111100001101100
11111111111011010100011000001100
00000000000011011110111011001100
11111111110111000101001110010000
00000000000001000111000100001101
11111111111010110110010001011011
11111111111111001111000110101010
11111111110111101111111110011000
00000000001001011000000100000101
11111111111101100011110101110001
11111111111001110100111100001111
00000000000000111011110011010011
11111111111011010010011000011001
00000000000011111110000110110001
11111111111111010111001111101011
11111111111011001101011010100011
00000000000001111100010100000101
11111111111000100110000101111101
00000000000110101100010010011011
11111111111010010001110001000011
00000000000001110011011101001011
00000000000001011001110000001111
11111111111000010010111111101101
11111111111010011011011111101001
11111111110010000100100110111011
00000000000001001110100010100111
11111111111110100000110100011100
00000000000000110011001001100010
11111111110000010000011111001001
11111111111111110010111111101101
11111111111110110010110010100110
11111111110010011111001000010100
00000000001100101010100011000000
11111111111100111001000101101000
11111111111010001001000000101111
00000000000010100001111111110011
11111111111001010100101011110110
11111111111100111100111011011010
00000000000000010001100000101010
00000000001100111011110011010010
00000000000110000100110100000000
11111111111101000001010101001100
11111111111111111011011100011000
00000000000010010010001011010000
00000000000001100000010000011000
11111111111000101011101110011010
00000000000001010101001001010100
11111111111001001001111000011100
00000000000000110010000111111111
11111111111010101001110101001011
11111111111111011011100010111010
11111111111001001111111110011000
00000000000111101101111110100011
00000000000000111110111110011101
00000000000101101000000101101111
00000000001001010111001100010111
11111111111111111111000001101111
00000000000100101001101000000001
11111111111001011100000000011011
11111111111010011111100101110011
00000000000000010111101101001010
11111111111110100111110010000110
00000000000101000010110000111011
11111111111111110000000001101001
11111111110101101000001111100101
00000000000011111101111100111011
11111111110100010101101010000111
11111111111111100001101000110111
00000000001001001001010111101001
11111111111001100101001110001111
11111111111011111110001101010101
00000000000010000011111100010101
00000000000001010100000111110011
11111111111010010100000111110011
00000000000011001000000101101111
00000000000111010001011010000111
00000000001100101010001000110010
00000000000000000100111101110110
00000000000000010110000111100101
11111111110101000100110100000011
00000000000011110001101010011111
00000000001000010100001011000011
00000000000011110011001100110011
00000000001001101000001000111111
00000000001000000011000111110111
00000000000111001101001010001001
11111111110100110110001110001001
00000000000011010001110111100111
11111111111010100100100011101010
11111111111110000111100100111110
00000000000101100000010110111011
11111111111101111010010111100011
11111111111111101100111001110000
11111111110001001010011111110000
11111111111101010010011110111011
11111111110101001101010000101101
00000000000110010001111010111000
00000000000001111010111110111000
00000000000011010111001111101010
11111111111100010110110101011110
11111111111100101100010010011011
00000000000111000001011111000001
11111111110011100010111010110011
00000000000001110100010100111001
11111111111100010000000100111100
11111111111110011001000101101000
11111111111001101001101011010101
00000000000101101011011010101111
11111111111101111111011111001111
00000000000101111111010010000111
11111111111110010011010000000101
11111111110110110110111000101111
11111111111100010000110010110011
11111111111100111110010111001001
11111111111101000000011101011111
00000000001100011110110111111001
11111111110101000011111111100111
11111111111011100100000010110111
11111111111111010110111111010010
11111111110101000111011011001010
11111111111000011111011011111110
11111111111100101101001010001000
00000000000110111001001100001011
00000000000000101011111110110001
11111111111010001111001101001110
11111111111110001010011111110000
11111111111100001010000101100010
00000000000111100010000011000100
11111111111100000101101011101110
00000000001011111011001111010000
00000000001000001010110110101011
11111111111100110000000001101001
11111111111011001101010111010001
00000000000000111011011100010111
00000000000101111000101110101100
00000000000110111000111011110010
00000000000001000110100110101101
11111111110101101110101001001011
00000000000000000100110100000001
11111111110111000100011001110101
11111111111110100110000101111100
00000000001100100101111111011000
00000000000011101101011010100010
11111111110110110101000110000100
11111111110111111001111101010110
11111111111001010100001011000100
11111111110100001011010000111011
11111111111100001001110101001001
00000000000111010000010101010010
00000000000010001010111001111110
11111111110111100011010101000001
00000000000000110001010110110101
11111111111100110010010001110100
00000000001011101111101101111110
11111111110100000011000111111010
11111111111101010001010000010010
11111111111110000101011110101000
00000000000010011000010100011110
11111111111101011011011111101010
00000000000010001101001010001000
11111111110101010111101001111001
00000000000010000111010001010011
00000000000100011100111000000111
11111111111011010110101000010111
00000000000000101100011000111111
11111111111110101101011010100011
00000000001000000110100110101101
11111111111001110000011000100101
00000000000001001101100001000101
00000000001000011010101110011111
00000000000110110001100011111011
11111111111010111001101001101011
11111111111011100110010110010101
00000000000011101101100001000101
11111111110011110000110110000101
00000000000011100111011011001001
00000000000001000010010000001011
00000000001011100000110001001001
11111111111101101110100101111001
11111111110111011101111001101011
11111111111110001111111011000110
00000000000010111111110110001010
00000000000000011101111100111100
11111111111000010111100000000100
00000000000000010111011100110010
00000000000010001000111010001010
11111111111001001111100100001010
00000000000010101101010111010000
11111111111000010001010011100101
11111111111100100110001100011111
00000000001011001000101101000011
00000000000000000101101000011101
11111111111101000100100011101001
11111111110101000100000010111001
11111111111010011101010010010110
00000000000001010110011011010000
00000000001100100010010000001010
11111111111100111011110000000010
11111111111011111011000010001010
11111111111111000011001110011100
11111111111100011001110110110011
00000000000000001101110001011101
11111111111111100101011000000100
00000000000001110000101111100000
00000000000000001110011100000011
11111111110110000001001000000111
00000000000011110000111111111001
11111111111110001111111011000101
11111111111100111010010100010010
00000000001011101001101000000010
00000000000010110001100111001110
00000000001100001100110110011110
00000000000100000100101010001100
11111111111010101000000101110000
11111111111010011011010101110100
00000000001000110000110110000100
00000000000001110010100101011111
00000000001010001111011101100101
11111111111101111011110110100101
11111111111000101100001011111001
00000000000110100101101111000000
11111111110110110111101001111010
11111111111010111100010000110011
11111111110111010110110010001101
11111111111100101100100110000110
00000000001001000110010011000010
00000000001000001011011110000000
11111111111101100011111100010100
00000000000010101011110001101011
00000000000101010101101010000101
11111111110111000100111101110111
00000000000011111100111000000111
00000000000111001100100110000101
11111111111100000001000001100011
00000000000101100110111010010111
00000000000011011110011010011011
00000000000010010010101111010010
11111111111110011101000101001110
11111111111001011001001111011110
11111111111010100000011010001110
11111111111000011101110011000111
11111111111101001111010111000011
00000000000010111000010100011101
00000000000010100000100100000011
11111111110101001001010001000111
11111111111101101110001000011001
00000000000010100011010001101110
00000000000111000100011101000100
