00000000000101100001001000000100
00000000001101011110100100101110
00000000000000101001100001011110
00000000000111101100101000010101
00000000010000011010110001101110
11111111110100010101001111011010
11111111111110101100010010011100
00000000001001100011111101010111
11111111100101100000100111010111
11111111100101111011101111111011
00000000001111101101001101011010
11111111101011001010001011001100
11111111111111111010101110011111
11111111101100010001101010101011
00000000001011111101010010010100
00000000001010101110010110011010
11111111100010101011011110000011
00000000000010011001010101110111
00000000000001101101001101011100
11111111111111001111110110001000
00000000000000010010111111101101
00000000000010010001101010101001
00000000001001110110111100000000
00000000000001101011111101001100
11111111111011100010111010110010
11111111101100000000101010000010
00000000000111011000111000100001
00000000000101110001100001000010
11111111110110100101010001100100
00000000000000001110010010110010
11111111110100010111111101100101
11111111111101010110010111100110
11111111111010111101011000111010
00000000000000011111100010110000
11111111011100101001101011010110
11111111101010011100110000111110
00000000000001111001101100111100
11111111111111011100100100001110
11111111111001101110010010010000
00000000010010010010101111111000
00000000010010111011000010001001
11111111110110100101001111100011
11111111111000101011100001010100
00000000000100001000100100101101
11111111111100000000100100000011
11111111111011001101110000001101
00000000000110100101001010111100
11111111100011100010011011110111
11111111111110011010101110100000
11111111101111110000110100110101
00000000001001100000000110100010
11111111101100110101001011001110
11111111111000000101001110010000
00000000000101011011010111000101
00000000001001001001111000011010
11111111111111001110010011101100
11111111110101100111010001010100
00000000001001000011011110111111
00000000001010100001110101111100
00000000011001010101010010111011
11111111111000111110001101010100
11111111111101001100110011000001
00000000000110010110000100010100
00000000000111111011000101100101
11111111111110001111010011110010
11111111110110100101111010101010
11111111110010110001011010001001
00000000000111010001010001111111
00000000010100000000000011001110
11111111111110100011110011111110
11111111111100000111100001101011
00000000000011111010000101011101
11111111110110100100001100101101
11111111110111110101011010100101
00000000000100101110011000110010
00000000000110010001011101001001
00000000001011010011100110111111
00000000001011011111000100001001
11111111101010011000000100001010
11111111111110111100011110001001
11111111100111111111011011111110
11111111110101010101100110010000
00000000001111010110000100010001
11111111101100000011000111011100
11111111111011010001010000010010
00000000001001111011101101010110
11111111110110101110000001110111
11111111110110001000100011101110
00000000001111100101101110111111
00000000011100001110110111001011
00000000010001000100010011001110
00000000001000001101001000001000
11111111110011111011111101001001
00000000001100101000011011101011
11111111101010101010011111110010
11111111111010001001100110110010
11111111110110111110000011011111
11111111101001011100011011101000
11111111111011100010001100111010
00000000000100000100100011011100
00000000001110110000101111011111
00000000100100001000111100011010
11111111110110101101010111010000
00000000010001110111010110011010
00000000000110010111101101001010
11111111111101011000111110011010
11111111111011000011111100010100
00000000001011111111011010111000
11111111110101101111101010101110
11111111111000001100111010011110
11111111101000110001001101000100
11111111111000001011001000001000
00000000001001111110010011110110
00000000001000010000000000111011
11111111111110010101111101101111
11111111110001110001111111011010
00000000011011001100001000100100
00000000000001100110010000100001
11111111111110111101011111011011
00000000000001010110100111000110
00000000000110100010110000111011
11111111111100011111000000011011
11111111110011110111001001001001
11111111111000111111101000010111
11111111110011010110101011101001
00000000100111101000000011101101
00000000001000011101001000011111
11111111111001001011111100001101
00000000010000001110011000110000
00000000000011000111001011010001
11111111111001000111111011111011
11111111111110111000001010110001
00000000000011100110001111110010
11111111111000001100100101100101
11111111111100111101101100100011
11111111111001101011101011000001
00000000010010111101001111000001
11111111111111010100101111011000
11111111101100001101111011010100
00000000001010110100001110010110
00000000000011001101000110110101
11111111111001010000101000101100
00000000000001100100101010001010
11111111111010110001000011001010
00000000001010011101101100100011
11111111110010001110011011111011
00000000000010000000101010100110
11111111111011001010100111110100
11111111110000100011110101110001
11111111100100011101100110001101
00000000001100001111010011110010
11111111111111001111110011000000
11111111111100111000101110101110
11111111111010011010001000010001
00000000001100111100010111010011
00000000010110001001000110010100
00000000001011000001101111011010
00000000001010010010100001000011
11111111101101100010010110110001
11111111111101111100001110011100
00000000010000110000001000001100
11111111110100010000010100001011
00000000001001101011111000001101
00000000001100001001011001101000
00000000010000111110001010000010
00000000000000001100110111100111
00000000001000010111111010010001
11111111110011001110110001000010
11111111111001111110001010000011
11111111101000100011010000000010
00000000000010001111100000110110
00000000000100000110100100111010
00000000001101011010000000101001
00000000000101011101110001100010
00000000010001000011111100010010
11111111111100011111111011001110
11111111110111011001111010000110
11111111111111000011111111110000
00000000001100111011011001000101
00000000011000010110111110011001
11111111111101011011101001011100
00000000000011110011000110000100
11111111111101010000011000100101
11111111111110111001100000101111
11111111101110010010101000110001
11111111101101001101001100001011
11111111111010011110000000001110
00000000001010010001101000100011
11111111111100010010001110100011
11111111111111110000111101111001
11111111111110111010000011111010
00000000000100110100111010110101
11111111111010100001000001100100
11111111111011011000111100100101
11111111101101000101110010010100
11111111110001101010001100111010
00000000010100110000001011011100
11111111111011110000111111001001
00000000010010110100100101010000
11111111111010101010010001110100
11111111111011011110010111001010
11111111111101010101011110000111
00000000001111000101011011010101
11111111111001001001101100010011
11111111111101100110101010000000
00000000000001100010000001111111
11111111101101110110111111010101
00000000000000010100000110110011
11111111111010001010000101100001
00000000000000001010010101000011
11111111111000100001101111011011
11111111101110001011111110110001
11111111111011010111100110101001
00000000000010010011011110000011
11111111111111100110110111000111
00000000001101001110110110010101
11111111110100110110000111100100
00000000001100110111110010111010
00000000000011000111100001101100
11111111100110001000100111011000
11111111111011111010000000101000
11111111111001101111100001101100
11111111101111110100111000111100
11111111101111101011010011010110
00000000011010101011011101111101
11111111101001001100100010101110
00000000001001111100000011101010
11111111111110110101111101111010
11111111110001110011111101111101
00000000001001010111000101111110
11111111110010101001000111010000
00000000010000111100111011001110
11111111111111111001011111111001
00000000000110010000000010111111
00000000010011110000100010011000
00000000011001000100101110110110
11111111111100111101110011000111
00000000000111000011110100011001
11111111111100100010111010110000
11111111111101111111010111010010
00000000001011010101110011111001
11111111111101001010111100110101
00000000011000110110000100010000
11111111110011110001000100101001
11111111110110001001000111010011
00000000000100101011000000111011
00000000000111000011000100101000
00000000000000001011001111011011
00000000000100101000001100010011
11111111111011111111010001110000
11111111110010010111100011010101
11111111110100001110100011111111
00000000000001011100111011011001
11111111110010011110000111001100
00000000001101001011100100100011
11111111110000001100100100110001
