11111111111110010010100000010010
00000000000000010101001011110011
00000000000000000100000100001111
11111111111111101011111001100011
00000000000000000110011010101010
00000000000001010011110100001000
11111111111111010110011011011110
00000000000001001110111001111110
00000000000001001001110001110010
11111111111111111110110111100110
11111111111110110000000000111001
11111111111111110000101111101000
11111111111111111001111101010010
00000000000000100010100010001011
00000000000000000011000000101011
00000000000000010011110010101001
00000000000000011001100110101100
00000000000000110101101111010111
00000000000000000111101000111111
11111111111111001011010001010111
00000000000000101100001111010000
00000000000000011001101000101110
00000000000000100000110101011000
00000000000001010001111010000100
00000000000000110110010000001000
00000000000000000010101100110100
00000000000000111001110100000101
11111111111111111010101111011010
00000000000001010110101110110100
11111111111110101101100110001011
00000000000000001010111010101011
11111111111110110111001101111001
00000000000000000011110100110111
00000000000000000011011110101000
11111111111111101100100101111111
11111111111110111010011011001111
11111111111111110110001101101100
11111111111110100101001001100011
11111111111111000010110101010001
11111111111111111100000011101100
11111111111111011001100000111101
00000000000001011110010011110000
11111111111111101110011001100000
00000000000000010000100101011100
00000000000000101101100100010001
00000000000000100100101111111011
11111111111110001101010100000110
00000000000000000101100101111011
00000000000000110011101100110001
11111111111111100011111111000000
11111111111110111000111110010111
11111111111111110010001001100001
11111111111111011100100011101010
00000000000000001011101001101111
11111111111110101111101000001101
00000000000001001101010110110100
11111111111111000110101000100011
00000000000001001100100100100000
00000000000000111001110100011110
00000000000000111110011010011000
00000000000000001110110111111001
11111111111101111110000011000011
11111111111111100101011100000000
11111111111110110100111011111001
11111111111111011000110001011001
11111111111111001011010100111011
11111111111110111011100001000111
11111111111111110111010011100011
00000000000001100101101011011010
11111111111111101100111001001011
11111111111110111001011011011011
11111111111111001000100100001011
11111111111111110101011001101110
00000000000000111000111010111011
00000000000000001110011010011110
00000000000000111100110011110110
11111111111111100100010101011110
00000000000000111110011010010000
11111111111111000010101101101001
11111111111111000010010001111011
11111111111111111010011100101011
00000000000000111110100011001101
11111111111111110100100001100001
11111111111111010011111111100001
00000000000001010110111011010110
00000000000000011101011101010011
00000000000000000000010000111001
00000000000000111000000010101011
00000000000000101001010010101110
11111111111111011100011101100001
00000000000000100010011111000010
11111111111111101100010111100010
11111111111111111111000100000010
11111111111111110001011001100110
00000000000000011001110001011011
11111111111111110001110110101011
00000000000000011011101101101001
00000000000000010100000110110001
11111111111111110110011010110011
00000000000001111100011000000001
00000000000000100101001110100100
11111111111111101111111010001000
11111111111111110101010101110001
11111111111111011000100000000001
11111111111111011000001100001011
00000000000000001101101110001000
00000000000000011011011100101001
00000000000010010010100111101010
00000000000000011010001011100001
00000000000001011011111001011001
11111111111111101100010001011000
11111111111110110101110110011011
11111111111111011001101001011101
00000000000000010001111111011111
11111111111110110000110100111001
00000000000001010010001011010011
11111111111110110000001100100100
11111111111111010001000101111100
11111111111111101000001001100001
11111111111111001010001101001101
11111111111111101010001101001111
00000000000001011011000110010000
11111111111111110010111110100111
11111111111110111111111100011010
00000000000010000110011111001111
00000000000000000011101011000011
00000000000000010010100001000010
11111111111111110010111111110111
00000000000001010101000100000000
11111111111111110001101111101101
00000000000000001100101001101101
11111111111111010011010111001011
11111111111111110111100000110111
11111111111111000010110011111110
11111111111111100110001011111100
00000000000000101100000000100111
11111111111111001001010110010010
11111111111110101100010110101100
11111111111111010100111000110101
00000000000001011110001100101001
00000000000001001111000001101001
00000000000001111011001111001101
11111111111110111100001011101100
00000000000000101000111101111100
00000000000000110111101010010100
11111111111111011001110011100111
00000000000000011000101110011101
11111111111111101110110010100101
00000000000000001010001110010111
11111111111111000101001010101100
00000000000001001101100001110010
11111111111111010011001010101001
00000000000000101011101110010110
00000000000001010101100011011000
11111111111111101101011100100101
11111111111110100001001110011011
11111111111111001100000001000101
11111111111111110011110011101001
11111111111111011001000110001010
11111111111111110000110000001000
11111111111111100000110101101101
11111111111111000010110011101110
00000000000000101010100100001011
00000000000000001001010110111111
00000000000000011110101000001100
00000000000000001101100101110101
00000000000000100001011010100101
00000000000000111111111010101111
00000000000000111001110100110010
11111111111111111000001010111010
00000000000000011101000111010010
11111111111111110001110000100001
11111111111111011111011110101110
11111111111111001011101100110010
11111111111111101111101100000100
11111111111111010001011001110111
00000000000001001010000011011011
11111111111111110101100100010100
00000000000001001001111100100101
11111111111111111010010011100011
00000000000001100001001010001110
00000000000000101100011111001001
00000000000000110001100010010001
11111111111111011110001010111001
00000000000000100001010011000010
11111111111111101001010011001100
11111111111110110001010111001010
00000000000000001100001011110101
00000000000000101000100000000100
00000000000001011011011001011000
00000000000000001010110110000010
11111111111110110010100011001001
11111111111111001001111111001110
11111111111111101001011001001100
00000000000000000011000010100111
11111111111111011101110010101100
00000000000001010100001111011110
00000000000000011011100111000101
11111111111111000010110111001001
11111111111111011101101001100111
11111111111111111010011111110100
00000000000000010100011001100000
00000000000001001111000101101101
11111111111110100101110000010001
00000000000000010010000011000001
11111111111110111001001001110111
11111111111111011101001110000111
11111111111111011100011111101101
00000000000000001101111110011100
00000000000000001001110010010110
11111111111111011001011100101011
00000000000000111111001100101010
00000000000001000010011110111010
11111111111111001111101100100011
11111111111111110011100010011011
00000000000000111000011100010101
00000000000000000001101010110010
11111111111111001101101101001010
00000000000001101010111111100001
00000000000000011011011000010101
11111111111111111101001111110111
11111111111111101000110100001101
11111111111111010101000110110101
11111111111111101000100010000011
00000000000001010101000101111010
11111111111111110010010111111011
00000000000000100101101110111000
11111111111111001110100100101111
11111111111110100000000010000111
00000000000000001001110000001010
00000000000000100111010111111010
11111111111110101010011111101101
00000000000000001010101010010100
00000000000000101110101100010010
11111111111111011110010100010110
00000000000000010000110000001101
11111111111111101100011110100110
00000000000001010001110010001111
00000000000000000111111100000110
11111111111111111100010011011001
00000000000000010101001101111010
00000000000000100101000101011001
11111111111111000001010011100000
00000000000000011110010010001111
11111111111111111010110000100011
11111111111111010010101000100010
11111111111111100011001101010100
11111111111111101001010000000111
00000000000001100000011101100000
00000000000001000001011101100110
11111111111111001111110010000110
00000000000001001101010001101001
00000000000000000111001110101000
11111111111111001000100100111001
00000000000000111100111111001000
11111111111110111001100001001111
