0000000000001001
0000000101101000
0000000111101011
0000000000110000
1111111101011010
1111111111111001
0000001000111010
0000000011010111
1111110111100110
0000000000110001
1111111111011110
0000000110011100
1111111111101000
0000001010110001
1111111101001000
1111111111000010
1111111111110101
1111111101110000
0000000010001011
1111111101110100
0000000010101100
1111111101100101
0000000100011010
1111110101101001
0000000011111100
1111111100101011
1111111101110100
0000001010101100
0000000000101010
0000000000111101
1111111100110100
1111111101100010
1111111101101000
1111111110010101
0000000101101101
1111111101110001
1111111111100101
0000000000010000
1111111011001010
0000000100010010
1111111010000011
0000000100000101
1111110000101011
0000000001011011
1111111011111001
0000000001110010
0000000110010100
0000000011111110
1111110010100000
1111111110100101
1111111010010101
1111111110010111
1111111111001101
1111111111101110
1111111111111110
0000001011000000
1111110101101001
0000001000001101
1111110101110111
1111110111100001
0000000110111001
1111111000111100
1111111111001000
1111111000110100
0000000000111111
0000000100001110
1111110111000101
0000000110000011
1111111001100100
1111111100100110
0000000100000110
1111111010011000
1111111010000011
0000000010111010
0000000111110010
0000000011110001
1111111010101100
0000000001100011
0000000011101000
0000000011101100
1111110110000001
1111111101000110
0000000111011101
0000000101001011
0000000110001010
0000001000101000
1111111101111110
0000001001011110
0000001101110001
1111111101101010
0000000100111100
1111110110010001
1111111001110010
1111111110101111
1111111100000100
1111111110010110
1111110101101110
1111111011000100
1111111000010010
0000000010111100
1111111110110011
1111111111010010
1111111000101001
0000000000000111
0000000001101010
1111111100110000
0000000000000100
0000000101101001
0000000111110100
1111111101100101
1111110111111010
1111111101001010
0000000101101100
1111111110010010
1111111010101000
1111110100111000
1111111101101101
0000000100111010
1111111010001011
1111111101010111
1111111111111100
1111111100111010
0000000110110010
0000000000111011
1111111110110100
0000000001110111
0000000101111010
0000001000111000
1111111010011110
0000000000010001
1111110111000011
1111111000000101
0000000101010011
0000000001010011
1111111010011101
1111110101000000
1111111111011110
1111111010100001
0000001001010001
1111111101110110
1111111101100101
0000001011110010
1111111101010100
1111111101011001
0000000011001100
1111111111100011
0000000000000111
0000000100110101
0000000000101101
0000000010110101
1111110111000001
1111111101110110
1111111000110000
0000000010100011
1111111000000001
0000000011010000
0000000101010011
1111111000100110
1111111100010010
1111111111001001
1111111001000001
0000001111001110
1111111101011001
0000000010100011
0000000011111000
0000001011111101
0000001101011000
1111111110101000
1111111100110010
0000000101000101
0000000101001100
1111111100111011
1111110100100011
0000001001011111
1111111101111010
1111111110110001
1111111110100001
1111111100011000
0000000110001001
1111111110101111
1111111101100100
0000000011110011
0000000000011100
1111111011110010
1111111000001100
0000000011010101
1111111011000110
1111111110111011
1111111111011001
0000000000111001
0000000001110110
0000001010010101
1111111110110011
1111111111011111
1111111000000010
0000000010111011
1111111001110111
1111110011001101
0000000111110110
0000000001111011
0000000000100111
0000001100110101
1111111111000001
0000000010010110
1111111110001111
1111111101001010
1111111100110000
1111111101110011
1111111111101111
0000000010000001
0000001000001110
1111111101011001
0000000000001001
0000001101110001
0000001010110110
0000000010101111
1111111101111011
1111111001000011
1111111111001011
0000000001000110
1111111110000101
0000000111011000
0000000000010000
1111110101011011
1111111110110100
0000000111010100
0000000000000111
1111111101110000
1111111111101111
0000001100111011
0000001110111101
0000000100011001
0000000010010010
0000000011001010
0000000000101101
0000000110001011
1111111100011110
1111111010010101
1111111011001111
0000000001101000
0000000001001000
0000001101001000
1111111011010111
0000001001100100
1111111101111011
0000001000111011
1111111101101111
1111111110101011
1111111111000010
1111111011111110
0000000110101101
1111110011110001
0000000100001000
0000000011101001
1111111100111101
1111111011011100
