1111111110111000
0000000000001101
0000000001110010
0000000011111011
0000000000000110
0000000010010011
0000000001110100
1111111101011001
0000000001000111
0000000000100000
0000000001011111
1111111111101110
0000000000111101
1111111100111000
1111111101000101
1111111110010010
1111111111100000
0000000010000011
0000000101000110
0000000000111011
0000000010001000
1111111010110001
0000000010100110
1111111111110101
0000000000101010
0000000010101100
1111111111011000
1111111101111000
0000000011101000
1111111100000000
1111111110010010
1111111100001000
1111110111111101
0000000010010011
1111111001101001
1111111101010001
0000000000011001
1111111110101011
0000000000001001
0000000011000001
0000000000000111
1111111110110011
0000000111011000
0000000100111110
0000000011010011
1111111111000101
0000000001110110
1111111010000010
0000000010001100
1111111111011011
0000000100101010
0000000000101001
0000000000110010
1111111110000001
1111111110011000
1111111110111011
0000000011011000
1111111111010010
1111111101100000
0000000100011011
1111111100110000
1111111011110110
0000000011001100
1111111011001001
1111111111101101
0000000000011110
0000000010110100
0000000001010100
1111111101000011
0000000001011000
0000000000011100
0000000001011110
1111111011110011
0000000000010011
0000000000010100
0000000100010110
1111111001001111
0000000000100111
0000000000010110
1111111110101100
0000000100010111
1111111111011001
1111111101001110
1111111011101010
1111111101111001
1111111101101011
0000000001111010
0000000001101010
0000000001001000
0000000110100110
0000000000011110
0000000001101101
0000000010101010
0000000001000010
1111111111100000
1111111110111011
1111111111010000
1111111100110000
1111111110011100
1111111111100110
0000000000110010
0000000000111010
1111111100001010
0000000000111000
1111111110011101
0000000000101110
1111111110101111
1111111011000100
0000000110010101
0000000100000110
0000000010101011
0000000010000100
1111111100100101
0000000001100011
1111111110001000
1111111100000111
1111111110011011
1111111101110101
0000000011001100
0000000010111101
1111111011011100
1111111101010011
1111111100101110
1111111101111001
0000000001001110
1111111110010011
0000000010111100
0000000011011101
1111111101011110
1111111111001110
1111111110000111
1111111111100000
0000000010001110
0000000010001000
1111111010110001
1111111011110110
0000000001010111
0000000001010010
1111111100000011
0000000001011000
0000000000110001
0000000110101010
1111111101111101
0000000010100100
0000000000111001
0000000101100110
1111111101000101
1111111001101110
1111111111101101
1111111001100010
0000000011011001
1111111100111110
1111111010110000
1111111010010000
0000000011001001
1111111110111110
1111111011010110
1111111101001100
1111111110101101
0000000010111010
1111111011001000
0000000101000000
0000000000111101
1111111111010010
1111111101010110
0000000110100010
0000000011011001
0000000000111000
0000000000101001
0000000001010000
1111111100111100
0000000000010101
1111111100010011
1111111110111010
1111111011100100
0000000001100101
1111111101111000
0000000100011001
1111111010010011
0000000001100001
0000000110000110
0000000010101001
0000000010111111
1111111111110101
1111111111011000
0000000101011011
0000000011101100
1111111111000011
0000000000000010
0000000010111111
1111111101111110
0000000011111111
1111111111010001
0000000001110110
1111111111100111
0000000000111100
1111111101100101
0000000001011000
0000000011111011
1111111101111110
0000000000000000
1111111110110011
0000000101001111
1111111101000101
1111111011110100
1111111110001111
1111111100000101
1111111011000001
1111111111111111
1111111100011100
1111111100100110
0000000101101100
1111111110000001
1111111101010100
0000000001110110
0000000000110000
1111111111100011
0000000100100111
1111111100111000
0000000011101101
0000000000010011
0000000111000001
0000000000001110
1111111100001111
0000000000010100
0000000100111001
0000000000101110
0000000000010100
1111111111100100
0000000100111101
0000000001001110
0000000000000010
1111111111101010
0000000101111111
1111111100101001
0000000100100010
0000000010101110
1111111111100001
1111111101101011
1111111111000010
0000000010000110
1111111111000101
0000000000000100
1111111101111011
0000000100010000
1111111110101101
0000000000101110
0000000000010011
1111111100110000
0000000000001101
1111111100010101
0000000111111000
0000000000111010
1111111010000011
1111111110100001
1111111011001000
