0000000001010000
0000000000000100
0000000000110110
0000000000100011
0000000000101001
1111111110101011
1111111111011110
1111111111110111
1111111110010011
0000000001110001
1111111110001111
1111111110011001
0000000000101111
1111111110101111
1111111110100010
1111111110101111
1111111111101001
1111111111010010
1111111110010000
1111111111001111
0000000000001100
1111111110100110
1111111111011101
1111111110000101
1111111110111011
1111111111111110
0000000000010010
1111111111000111
0000000000011010
0000000000001011
0000000001011001
1111111110101001
1111111110100000
1111111110101110
0000000001010010
0000000001000111
1111111111101100
1111111110010001
1111111111100001
0000000001101100
1111111111010000
0000000001101001
0000000000010110
0000000000101000
0000000001100010
0000000001010010
0000000001110010
1111111110010001
1111111111010101
0000000001001111
1111111110110111
1111111111011001
0000000001001100
0000000000110010
1111111111110001
1111111111000100
0000000001001101
1111111110110000
1111111110011000
1111111111011111
0000000000001100
1111111110001100
0000000001110111
1111111111010111
0000000000000010
0000000000000001
0000000000111111
0000000001001110
1111111111010010
1111111111111110
1111111111001100
1111111110111000
1111111111110100
1111111111010001
0000000000010100
0000000000110110
1111111111001111
1111111111011110
0000000000011011
1111111110010011
1111111110010110
0000000000001111
1111111110111001
1111111110111101
1111111110001101
1111111111011011
1111111111110110
0000000000001000
0000000001010100
1111111110101001
0000000001001000
1111111111011000
0000000001110000
0000000000001101
0000000001011100
0000000000000010
0000000000110110
1111111110101001
0000000000010000
0000000000111101
1111111110000101
0000000001000001
1111111111011111
1111111110011110
1111111110110100
1111111111001101
0000000001101110
1111111111110011
1111111110110010
0000000001010001
0000000000011010
0000000001100111
0000000000111110
0000000001001010
0000000001010010
0000000001001101
1111111111000011
1111111110101000
1111111111010110
0000000000110111
0000000000011001
1111111111000000
1111111111001101
0000000000101001
1111111110010011
0000000001010110
0000000001101111
0000000001000001
1111111111111100
0000000000101100
0000000001101011
0000000000001011
0000000001000000
0000000000101000
1111111111111011
0000000000000010
0000000000000100
0000000000001011
0000000001110000
0000000000110000
1111111111011101
0000000001000011
0000000000010111
0000000001000110
1111111110110101
0000000001110000
0000000000011101
1111111110010110
0000000001001100
1111111110110110
0000000001111111
0000000001001101
0000000000110110
1111111111010100
1111111111000111
0000000001101110
1111111110101000
0000000001100111
1111111111010010
1111111110101111
0000000001001111
0000000001111111
0000000001111010
1111111111000100
1111111110100111
0000000000110001
0000000000110101
1111111111110001
0000000000010010
0000000001011000
1111111111011011
1111111111110111
1111111110110111
0000000000010001
0000000000000111
1111111110010101
0000000000110010
1111111111001010
0000000000000011
1111111110101000
1111111110011000
1111111111000110
0000000001111000
1111111111111100
1111111111000001
1111111111010000
0000000000001101
1111111110110111
1111111111100010
0000000001000010
1111111111001010
1111111110100011
1111111111100110
0000000001010111
0000000001000001
1111111111111100
1111111111001001
1111111110001010
1111111111110110
1111111111100111
1111111111011101
1111111111111100
0000000000100000
1111111111010001
0000000001011000
0000000000110010
1111111110111101
1111111110101000
1111111111011000
1111111111100000
1111111110010101
0000000001100000
0000000000010011
1111111110010100
0000000000010110
0000000000111001
1111111110000001
0000000000001110
0000000001011001
1111111110011110
0000000000011100
1111111110010010
0000000000000001
0000000000011000
0000000000010110
0000000000001101
0000000001101100
1111111111010100
0000000000111010
0000000001100000
0000000001101010
0000000001000000
0000000001100011
1111111111010010
1111111111101001
1111111111001010
0000000000011010
1111111111100001
0000000001111001
1111111110100011
0000000000101110
0000000001010111
1111111111000000
1111111111000111
0000000000100000
0000000000101001
0000000000011101
0000000001000001
1111111110110010
0000000001100101
1111111111000111
0000000001010011
0000000001101000
1111111110000010
0000000001111011
1111111110110101
