11111111111011011101011100001010
11111111110101100011000010110100
00000000000111001100101111111010
00000000001001010011001110110111
00000000000000011000111011110100
00000000001111111011111000010100
00000000000111001111000110101000
00000000000000111000111101000001
00000000000100011100100111101111
11111111111001000101110010100000
11111111110100010011001100110100
11111111110011010110001101100001
00000000000011110000010010000001
11111111111110111010000111000000
00000000000101111110000000001100
00000000000001111011011001101111
11111111111101110110101000011000
11111111111111001111111010101111
00000000001010100011011000001111
11111111101010111110010110101000
00000000001000100011011000010000
00000000000011110000011000111101
00000000010100100010110111011101
00000000001000010000101100110000
00000000000010101111000011011000
11111111110000010010101101101101
11111111111001000000000011010011
11111111101111111000111001001111
00000000001110100010001001101000
11111111110111011100001011111001
11111111111101100000000000000001
00000000001010110000100100111111
11111111011111101000101101000110
00000000001100000101111010100100
00000000000000101010000101100010
11111111111010110000010100110100
00000000000001100010001001101000
11111111110100111000000010010110
11111111100110011101011111011100
00000000001001001011111000101110
00000000000000011001110000001111
11111111101000000100000101010110
00000000000111010111110000011010
11111111111100011001001000100110
00000000001101001101010111001111
00000000010011111111100110100100
00000000011101101011010100001000
11111111111011000111100010000000
00000000001000110101101010000100
11111111111011101100001010010011
11111111111001011101110110011000
11111111111000000011000010111100
00000000000011001010110110101100
00000000000010101010010000111011
00000000010010110100111000111000
11111111111101101011110110100110
00000000001101100011101111001011
11111111101100010101001101000000
00000000001100101100001000100111
11111111101111010011010011111010
11111111110010110111100110100111
00000000010001110110101011010010
11111111110110000001000001100011
11111111111101001000001000100000
11111111111110110101100000001111
00000000000101110110100010001100
00000000000001110000010010000000
00000000000101100010101111100001
11111111110100000000100100000101
00000000000101010110101011001100
00000000001011010101110000101000
00000000000001110110100011001011
11111111101111000101011110101010
11111111111010101110111010101011
00000000000001011011001111001111
00000000000010011110000011100011
11111111100100110110010100101110
00000000010001011101010111101111
00000000000001001001111011101101
00000000000001001101011101101111
00000000010001011100011101111001
00000000000110100111100001111010
00000000000111100111110101010110
11111111110110100110001101110100
11111111110111011011111101001011
11111111101110011110001101001000
11111111110100110000001110110010
11111111111101100100100010010110
00000000000100011110001101010010
11111111111011101001110111010101
11111111111101111111001000010011
00000000000100001111011111111000
00000000001010101011100001010010
00000000000110110101011110000101
00000000000001111101110011000101
00000000011010100001110110111010
11111111111101000100010011010000
00000000000011100010010001100010
11111111110000011101001011110101
00000000000011101001001101010110
00000000000011000101100001111010
11111111111110010011111001010100
11111111111001101011001101101001
11111111110010111110111011101100
11111111111001111000010111110000
00000000001000010011100010100100
00000000001010110100110010011000
00000000010000011111001100101110
00000000011001011001111101010100
11111111101011111111100111000000
11111111111011000000100100000100
00000000000010111001100101001110
11111111110010001100011111100101
00000000001011111000111000001111
00000000001100110000000001101000
11111111110111000101101010000100
11111111111001100111000000111101
11111111110000010010111111111101
11111111111000011100110001100110
00000000000110010010110100010000
11111111101101101100001111001011
00000000001110000010010111100101
00000000001011110000001000001011
11111111111001001110000101100011
00000000000100110110010001011001
11111111110111100111000110100111
11111111110010110000100010011101
11111111110101000001111000110101
11111111110101110001111010111001
11111111101111011000001110000001
11111111101010110100010001101010
00000000001000100100110101100001
00000000001000111111010101011001
11111111111110000101010111111101
11111111111000011000001101111100
11111111111100110010001101000001
00000000000101010110101000010110
00000000001010010011010100100110
11111111110111110001100011111011
00000000011010110010000110111010
00000000000011001010011100011100
00000000000101011111111000001110
11111111110000000100000110001011
00000000000101000111101001010010
00000000000011011110111011001100
11111111110011101101000110110111
00000000001101101100010010011011
11111111100110000000101011101000
11111111111110110111111010010000
11111111100110101010110000001101
11111111110100010111010010111101
00000000010110100010000010000000
11111111101010111000111000100100
00000000001011101101001001101110
11111111111010110001111110001001
11111111110100101100111110011001
11111111101101010001100011111110
11111111111011111100101110101100
00000000001100101011011010101101
11111111101000111001110101011101
11111111101100010110011000000000
00000000000011100100110111100000
00000000001101100111011011000111
00000000011010001100000100100001
11111111110101010100011011011100
11111111111101000011100101001100
00000000000011110110111000101101
00000000010100001010010110101011
00000000000010100111100001101100
00000000000110010000110011101110
11111111101110001000001001000001
11111111111011101110110111110010
11111111110001000001100010010100
00000000000001011111010100011110
11111111110011101101011010100011
00000000000100111110000101001110
11111111110111010110010001011010
11111111111111001111101011110001
00000000001011110110100001110011
00000000001010101000001111101000
00000000011000100111111000100110
00000000000110000100100101111001
11111111101001000001011000100001
00000000010001101110011000101010
11111111111101011110101110000110
00000000010000001010011000001111
11111111110111110011010011010111
00000000001100000000000010000101
00000000000000000010111110000010
11111111111011111111010110011001
00000000001110110100000001001101
00000000010101111001010011110111
11111111111101000001000001100100
11111111110111110100100110101111
00000000001111110010101100000010
00000000000101100001101001000110
11111111110110001101000000010100
00000000000011101100001010011011
11111111111110011101000101001110
00000000000111100001001110011000
11111111111111111111001000010011
11111111101011111100111101100101
11111111110000001100011111100100
11111111111000111010100000010001
11111111101111000100100011101011
11111111110100001101001011010101
00000000010101000010000011000010
11111111111011001011100010011001
11111111111111111110101010110011
00000000000011000000011011010101
00000000000111010110010100101011
11111111110101001001111000111111
11111111110111111111110010111011
00000000010110111010101010000101
11111111110010010010101000110011
11111111110001110010000111011011
11111111111110001011111011100000
11111111110000110011111000010110
00000000000000111100010000110010
00000000011100001111110111010000
00000000000001001011111011100000
00000000001111000010111001111000
11111111110011010101001001010110
00000000010010011111110110101010
00000000000001010000011011110111
00000000000000001010010000010101
00000000000100111000100100111000
00000000010011111110010111100011
11111111111110001100011100010001
00000000000001001100100101001001
00000000000010110100111000111100
00000000010011101000101001010011
11111111111110101000110011101000
11111111111100000010100001011101
11111111110110100011100010000111
11111111111101111111111100110100
00000000001011000111010100100100
00000000010010001111000101101111
11111111110010011110101110000101
00000000011000000111101000001000
00000000001000011111011111001100
00000000000001001100100000101101
00000000000010111101100101111111
11111111111010110001000000100111
00000000010001000111100001101100
11111111110111101011101101001111
00000000000000001101110001011101
11111111111100011010110111101001
11111111110011000010101010011001
11111111101100100001100100110010
11111111111001111011011100011001
11111111101000000001001111100001
00000000000011101001100100101111
00000000011111101011101000100110
11111111110001001111100000111011
00000000000000101110111111010011
