00000000000000001010101000110101
00000000000000001001100010001101
00000000000000001011010011000010
00000000000000000010010110101000
11111111111111111010100100010110
00000000000000001111111001111100
11111111111111111010100010000001
11111111111111111100110011100111
00000000000000000000100010111011
11111111111111100100000010111111
11111111111111100100111000011100
11111111111111111110101000110110
11111111111111111011101000010110
00000000000000010000001000010010
11111111111111101001111101100100
11111111111111111110010010110110
11111111111111110111010001010100
00000000000000000010110011011010
11111111111111101011101101001011
11111111111111111000000111010111
11111111111111110110001011111110
00000000000000001100110110100100
11111111111111101100001100100001
00000000000000001011000010110001
11111111111111110110111100100010
11111111111111110111101011011010
11111111111111111011001011101011
00000000000000001001011101010001
00000000000000000100101110110010
00000000000000000001111001110000
00000000000000000000001110110110
00000000000000010110001001101110
11111111111111101001100111100010
11111111111111111110010101110100
00000000000000010011001111100011
00000000000000000001011111001001
11111111111111101111011011100100
00000000000000001011010110011100
00000000000000001001101000001001
11111111111111101110011011111111
00000000000000000111000110001001
11111111111111101100101111000001
00000000000000000111110101011100
11111111111111111101101110100000
00000000000000010110100111000000
00000000000000000001111010110010
00000000000000000000010011011101
00000000000000011100001111100011
00000000000000000100100100111110
11111111111111110000100111110110
11111111111111110001111011000000
11111111111111111011101100010000
00000000000000001111110110010000
00000000000000000011010011010000
11111111111111110110011111010000
00000000000000000101100111010100
11111111111111111111101110101100
00000000000000010011110000010100
11111111111111101110110110110100
11111111111111110111000111110010
11111111111111110010111110111111
00000000000000010000001100001011
00000000000000001001101010000110
00000000000000010100000111100100
00000000000000000000100100001001
00000000000000000000001010100011
00000000000000010001101011001101
11111111111111111110000110000011
11111111111111111001111010011000
11111111111111111010100000111000
11111111111111110000010100111010
00000000000000000010100001100110
11111111111111111000011111001001
00000000000000000100010001001101
00000000000000001001011000101010
11111111111111111011101111101000
11111111111111110101011111101010
11111111111111111110000011010010
11111111111111110101110000111101
00000000000000010001001000001011
11111111111111110100101010011001
11111111111111110000101110100001
11111111111111101110100110010100
11111111111111111111100010100000
11111111111111101100111011010100
11111111111111110110001101101000
11111111111111111111110010111010
11111111111111111101101001010010
11111111111111111111101000010000
00000000000000010101100111000000
00000000000000000011111001011100
00000000000000001110001001000000
00000000000000001111110100001101
00000000000000001100011000010001
00000000000000001011110101100011
00000000000000001011010010010101
11111111111111111011111111001100
00000000000000010001110000101000
00000000000000001001101111100111
11111111111111111010011000111111
11111111111111111000101101101011
11111111111111101000011000110011
11111111111111101111011111101010
00000000000000001000001000110100
11111111111111101111111110010010
11111111111111111100111000001110
00000000000000001100001001000111
00000000000000001111100010110011
00000000000000000000011001111010
11111111111111101100000000111100
00000000000000010000001110001000
11111111111111110110010110111100
00000000000000010001001110111100
11111111111111111110011111011100
00000000000000010011111011011111
00000000000000000000100110010011
11111111111111101101001111011111
00000000000000000011011110100111
00000000000000000001100010101101
11111111111111110011110000110111
11111111111111111011000110110111
00000000000000001011001001010011
11111111111111111110110010100101
11111111111111110100010011010001
11111111111111111101000110001111
11111111111111100111011001111011
00000000000000010110000101110100
00000000000000000101110001100100
00000000000000000100111101001000
11111111111111111001111011110100
00000000000000001110110111011111
00000000000000001011111100101111
00000000000000001101000110000010
00000000000000000011000011011000
11111111111111111111100010000110
11111111111111111111000000100010
00000000000000000001111110011101
11111111111111111111000101010101
00000000000000010100001011110111
00000000000000001000000011010001
00000000000000000100000001010101
11111111111111110011000111001011
00000000000000001011101110110010
11111111111111111010001011000100
00000000000000000100101000110000
11111111111111101000100011010000
11111111111111110110011000110010
00000000000000010001000101011010
00000000000000000000010010011100
00000000000000010010110110101010
00000000000000011001100111011010
00000000000000000110001111001010
00000000000000000001001100100110
00000000000000001100011000111110
00000000000000000110101101111000
11111111111111101010111110011110
00000000000000000001111000001110
11111111111111101000000101100010
11111111111111101111111110110010
00000000000000000100011011011100
00000000000000011001111001000001
11111111111111111001111010101011
00000000000000000111110101010000
00000000000000010110110110111110
11111111111111111011000000101110
11111111111111101110100010000000
00000000000000000100110001010000
00000000000000001000100110001100
00000000000000001101010101110011
11111111111111110111010011110001
11111111111111111010000010011000
11111111111111111100011110011010
11111111111111111001000100101110
11111111111111110100101010101110
11111111111111110011011111011100
00000000000000001110011111010100
11111111111111111111100000101011
00000000000000001101000011110001
11111111111111110101010100111001
00000000000000001011100001001011
11111111111111101011100100100101
11111111111111111010001111110001
00000000000000001110011001101101
00000000000000001111100110010011
11111111111111110001111110011111
11111111111111111110000010010111
11111111111111111000100110011001
00000000000000001010110111110011
00000000000000000100100000100100
11111111111111110011111000001110
11111111111111101101011111110111
00000000000000000100110110101011
00000000000000000111100101110010
11111111111111110001101111001110
00000000000000000111101011011010
00000000000000001000110001000010
11111111111111101010001101101001
00000000000000000111111100110101
11111111111111111011100011001111
00000000000000000001110110011111
11111111111111111011000000101111
11111111111111111100001010101001
11111111111111111110000100010100
00000000000000001001111101111100
00000000000000010001010110101000
00000000000000000100110001001010
11111111111111101100100001000110
00000000000000000010101010111010
11111111111111110110110101001010
11111111111111111110111100010100
11111111111111111110101100100011
11111111111111100110100000011111
11111111111111110100110111011010
00000000000000010000000100001100
00000000000000001001111011000100
11111111111111111011101000010000
11111111111111110001110110010001
11111111111111101110001101101001
11111111111111111110111001110111
00000000000000010111011100011101
11111111111111110101101010100000
00000000000000010001011000010000
00000000000000000011010001100110
11111111111111111101000110110000
00000000000000000100100010010011
00000000000000000001001011010001
00000000000000000111111101001001
00000000000000010011001000000101
00000000000000010011011001111001
11111111111111111011010001101101
00000000000000010101011101100101
00000000000000000101001101110101
00000000000000000110100101011000
00000000000000010010001011111110
11111111111111110110010001111100
00000000000000000011111010111110
11111111111111111111011011011100
00000000000000000111001110001000
00000000000000000011100000010000
00000000000000011010111100011010
00000000000000010000101100000001
11111111111111111010111001001001
11111111111111110000110010111010
11111111111111111111001001110110
00000000000000001001001110011011
11111111111111111110111101001111
00000000000000001011111110010000
11111111111111111011011111001000
00000000000000000010110100001000
11111111111111101001011100010010
00000000000000000011010001000000
11111111111111101110010001100010
11111111111111111101001111101011
00000000000000011100110000111011
00000000000000000101111011100111
00000000000000011000111000100111
