11111111010001100110101010000001
11111111111011000111111000000100
11111111110101011101010010011110
11111111111110011101010010111001
11111111010111011110110111001010
11111111110010110000011000010101
11111111101001101101011110111110
11111111000011111001110011101001
00000000111011111110011001111011
00000000000010000110110000100101
00000000110100101101110100000000
00000000011101010110011010001101
00000000111111100000110010010100
00000000000001110001010100111001
00000001101111000000000111010110
11111111100011010000100110001110
11111111001000011001110011000010
00000000111000000100100110001000
00000001101001111000011001110010
11111111111100000110000111000110
11111111001101100010110011000001
11111111100011100000100000100101
00000000110001001110110010100111
11111111001110000101000101001111
11111111101010101111001001000101
00000000001001011010010001100110
00000001111110110100001011010011
00000000010110000101101011101001
11111111010100000101001000010100
00000001010001010001110110100000
00000000101101001100110100001000
00000001000101000110000110010110
00000000101011100010000011000011
00000000010101001111110100000010
11111111111000101111001100000100
00000000011000111001000100010011
00000000100110100011110000000101
00000001010101110110011100101011
00000000100011101011011111110100
00000000010010001001110010110100
11111111101100010101110010101111
11111110011110000001011010110110
11111111011010111111000101001100
11111111110010011001110101110100
11111111001000011101110100000011
11111110111111101010100010010010
11111111011011100110010000001100
11111111001111011110000010101011
00000001010101010001111001010101
00000000100001010101000100111000
11111111000010010110101011000000
11111111111000101110011101011111
00000000011111111001011001100000
11111110111111001101000110011101
11111110100111100011010011010010
00000000010111110011010110000001
11111111100111100000110111100000
00000001001000111101100010101010
00000000010100001011110100011000
00000000000010011110001001000011
11111111111011110010101010011010
11111110110011111110100111011000
00000001111001110110110100001111
00000000010010100111010110110110
00000000011100010000100010011001
11111110111110110000000001010110
11111111101111101011111100111100
11111111111001111100011101101111
00000001011011001111101101000110
00000000001001011110001000100101
11111110100000101101000111001110
00000000100100001110100111000111
11111111010001100011101101101111
11111110100110101100011011010101
00000000110000011110011111011100
11111111000011111101010000011111
11111111110100100101110001000110
11111111110101100001011001001101
11111111011111011101011011110000
00000000100101001110011001100100
00000000000010100010000110110010
11111110110111110100010001000110
11111111100101000100101111010010
00000000110011001101001000001110
00000000010001100010101111101001
00000000111100100110101000111011
00000000011101101101101110001101
11111111011011000011100000100001
00000000001110101010000111110001
11111111111001011101010001110110
00000000001010110001010000001111
00000000010010001000110011011001
00000000011101101100011001010010
11111111011011000101100010101110
11111111100111010101011000111110
11111111110101000111000100010010
11111111101000100101101111000111
00000000001000110011001110001000
11111111101111110000111100011010
11111111111111001110001111000001
11111110110001011110111010011011
00000001011010011010010000101111
00000000101110100110101110011100
11111111010000110101100111000100
00000001000101101001001010001111
00000000010010110011000101111100
00000000000101000111101111010100
00000000000101010110110110001000
00000000101111010111111101001111
00000000100101000111100001000100
11111111111001010111001111110110
00000000000011100001110111010111
11111111011101000011101101011011
11111111011111111110011000010110
11111110111111100110101000001100
00000010000101001010010011100001
11111111111010000001011111101110
00000010001000110011011110111111
00000000000001010010001001011110
00000001001011111110100011111111
11111110010111101011010110011010
11111111101010001100101010001110
11111111110001100011110010100010
11111111010011010101101010110011
11111111101000111100110001101100
00000000101101111100010101101110
11111111101101011110110011100011
00000000001101111001100000100110
11111111000011111001011001011001
11111111110011001100100001000001
11111111100101101010110101000110
00000000010001000001101110010001
00000000010000000100011000101010
11111111001000011101001110111110
11111111110110110001001010000000
11111111100101101011101101101101
11111110001010110010011110001010
00000000000001010000101011100100
11111111111110111110011110011010
00000001001111110110101101001010
11111111000100001110000111000010
11111111011110000101111011010110
00000000101011010100001000100101
11111111010110001000110010100000
11111111010111011000101101010111
00000000010000100110001010000110
00000000010010111100000001101111
00000001011010010111100011011001
00000000011011001111110100000000
00000000010110010010011100100110
11111111100100010011011110011010
11111111100110000110001101101110
11111111101111101101111001101010
11111110110001011011010111100110
11111110110111100100110011111101
11111110011110011011100011100011
11111110101011110101000110001100
11111111010101011000010100100110
11111111101111010011101110001000
11111111000111000100011111100001
00000001001011010000110110000010
11111110110111101010000101110100
00000000011001100110100101111110
11111111100000011111011001001011
00000000101110010101001011011101
00000000000001000000101111101100
11111110101101111110110011100000
00000000011100101101001110000110
00000000010101111000101010011000
11111111001110110001011010100001
11111111010101011101000010111110
00000000110100110101100010001110
00000000010000000000101000011111
00000000011110010001010100111000
00000000011000001011100010100011
00000000010000010110101001011011
00000000101001010000001010100101
11111111110101101110111011000111
11111111110100000001110000111010
00000000010001100001111101000011
11111111011101010010101010110110
11111111110011000000101000001101
00000000111110010110010010100010
11111110100111001110101100100001
11111111111111100010100101111111
11111111111101101110100001011111
11111111010100111111000011111011
00000000110111101111000001101010
00000001010101101110000011010011
11111111110101010101001000101111
11111111110000000000000010100011
00000000100001100001100001000011
11111111010110101101000110111101
00000001100000100011100011010111
00000000001000011111101100101000
11111110100000001110000011111011
00000000000110111100011110011010
00000001000100000101011001101010
11111111010011110110110101010100
00000001010001111001100001100101
11111111110110111110111101100100
11111111110010010110010011011100
11111110010001000011001010011100
11111110101110000000111001100010
11111111011111111100001111111110
00000001001011010100001010100110
11111110010110110110000011101011
00000000101101001100001001101100
11111111111000000101010010110111
00000000001010001000001101100010
11111111101010100010001111011111
00000000100000001110011010111001
00000000010010010111111101010010
11111111110001001000101100101110
00000000110110011110010101101110
11111111011001100001011110110010
11111111110110000000010100100110
11111111010110010111010010111000
11111110101111010001000000000111
00000000010001000000100011110101
00000001010110100011000110010110
11111111010100111111001101101010
11111111010100101010100101101110
11111111000110110011110110110011
11111111000000001010000101100100
11111111100111000101001100100100
11111110111011111000110100111100
11111111110111110110001010000101
00000000010000000011011101110111
00000000100110011011100011000100
00000000000111011000000001111000
11111111010100111101010011010100
11111111110011101111001100110010
00000000011011000100110111110111
00000000001001001111001010010100
11111111111010110011011011000010
00000001010111010011110001111101
00000000000110000101011100010100
00000000100111101000110111111101
11111111100011111100101011101101
00000000111010010100110011001001
11111111000110010010100111010001
11111111100010110000001110110000
00000000110000111100110111000111
11111111001101111101111000000000
11111111100011001111010000011111
00000000111011001010110110011010
00000001000000010111010001111011
00000000010010110000001101010001
11111111001001110101110010001011
00000001101010100111011110111001
00000000101101110111100011011010
11111111111101111110100000011111
11111111100010001110011111110001
11111110111011110100110000000111
00000001010101000011101011111101
