11111111111111111010000011111001
11111111111001001000111010000000
11111111110011110100011110100001
00000000010111101101101000100010
00000000000000011110001101010101
00000000100010100100110111101010
11111111111010100011110110010000
11111111111011000000010010100011
11111111110111000000110100011011
11111111110001111101001011101000
00000000011010100101000001010011
11111111111010111000110101001100
00000000000000010011101010010011
11111111111101010010111000111110
00000000010011111010010111000000
00000000000110110001100111011111
00000000000000100101101011110000
11111111111000011000101111001111
00000000000000011000010000001010
11111111011111011110011000001101
00000000010001111110000110101100
00000000000110110100110100101111
00000000011110100010000111100001
11111111111111010101011100111001
11111111111011000111100101000000
00000000000110000111000110001111
00000000010100101110100000010100
11111111110110011110010101000011
11111111111111001000101001110100
00000000000000101011111101001011
00000000001010100011100111011001
00000000010001001011111100100111
11111111100000000010011101010101
11111111111001100101010001100010
00000000001011000010111011110000
11111111110101100011100010101111
00000000000101100001100101100101
11111111110001101001010010100000
11111111001100110100101010010000
00000000011000100101101001110000
11111111011111001110111100110111
00000000011110100110100011100110
11111111110110010001001111010100
11111111111111111101000110111001
11111111111101100010101101101011
11111111111000000110110010001100
00000000000000000110010100101000
11111111111001110010000111101100
00000000010110011001011001001111
11111111100110000011011011001110
11111111111010111111101000101111
11111111011010010000001100011100
00000000001010001100101001011000
11111111111110011010100010110000
00000000010101011001100101000111
11111111111101010011101010111010
11111111111011010001111010111001
00000000010001010100111001011000
11111111110111111100000100000001
00000000010101110101111001011100
11111111111100001001000100000000
00000000000110111001111111000110
00000000010000010000001100101001
11111111111110000100000010010010
11111111101101111010111110111001
00000000000100000111000110000010
11111111111111011010111110011111
00000000000000101100010101001101
11111111101000101100111101000110
11111111110100000011111101101110
00000000011001110100000100100100
00000000000001001000110100101110
00000000001111110000000001100101
00000000000111100101111110010110
00000000000100000101100101100001
00000000001010011001001001110101
11111111111111010100001011000100
00000000010110101001011000101010
11111111111100110111011100101100
00000000000010100100010001101000
00000000010101111010101011001011
11111111110111110011000111000010
11111111111010001000010101011110
11111111110000101000111101011011
00000000000011100000000000000010
11111111100000001011111001100000
00000000000010011100110101011100
11111111100111010011001100011110
00000000001100111110010000100111
00000000010101011011111100110010
00000000010101000111010101001110
11111111111100100011011110001101
11111111101011010111111010010100
11111111111100110000100000110000
11111111100111000011101000001000
00000000010011110101111000001110
11111111110110111100101011000000
00000000001100001101010001010100
11111111111011100110100010111011
11111111111110111000000000110001
00000000001101010101110111001100
00000000001101001010111110011100
00000000001101101000011010011000
11111111110011010011001001110101
00000000000011001011111011100000
11111111111010110111010001110000
11111111100101010011110100101111
00000000001000011010011001111011
11111111111000110101001100101000
11111111101111011100110100001100
11111111100101101110000000111010
11111111110010101010101101100011
11111111011111111000101110110000
00000000011010001100111101101101
00000000011101101001001011100101
11111111111010111101110110000110
00000000000110010000010101010100
11111111001110111001011100101111
11111111111011110101011000011110
00000000010011000010010110110010
00000000000100100000010000011010
11111111111101100100110010110001
11111111111011110110110111101011
11111111110011001101011110000010
11111111101100111101101100100110
00000000010001101100100011001011
11111111110101000100001010101110
11111111111001100011010001101110
11111111111011001000100011001111
11111111111001001001111010000110
11111111110010111111010001101100
00000000001000110101010000111111
00000000000101110010001110100100
00000000000010001101001111101011
00000000000010100010001110001110
11111111111010000011101011011101
11111111110000011011010010100011
11111111100101100110100001111100
11111111100010101001010001101000
00000000001000010100011010000011
00000000001100001100011100001110
11111111111001111101100000001111
11111111101110001110001101101010
11111111111111100000101110100101
11111111101110010111110011110000
00000000000000101010001011110100
00000000000000110110010110100001
11111111001101001110110000110111
11111111110011110110001010110110
11111111011110101101100101010000
11111111111000011101000101100001
00000000101100101010000110101111
00000000011000100110000010101000
11111111100110110000000001111010
00000000011010100010001110010101
11111111111110110010100110011001
00000000001001111001101001101010
11111111101110100111111011001010
11111111110000010001100000011001
00000000000000011001111101010001
11111111101110111101111001101100
00000000010010010101011110100100
11111111111111011001000111010011
00000000010100110000111101011011
11111111100111111010011010110011
11111111110111011011111101000110
00000000000000011110111101110110
00000000010000111010001111000010
11111111101001101110110110010100
11111111110100110100010000011100
00000000011011110101101110111011
00000000011111100111001011100111
00000000000010101110011100000101
00000000000010101011001101010010
00000000000111001110110011100100
00000000010111011010011110010100
11111111110100110100111111100000
00000000010101010111100111101101
00000000001001111101110100110000
00000000000101101110100101010101
00000000011100010101101010000011
00000000000111110100101100100100
11111111011111010100011111001010
11111111111011101001100001100111
11111111111001110111100011010100
11111111101001000111101111110101
00000000001101101111001110110110
00000000001111100001111001111011
00000000010100111010000111001001
00000000000100010100011111001110
11111111110010101110010001111000
00000000100111110011001111101101
11111111111101000000001001110111
11111111100110010100011111011110
11111111111001111100110010001110
00000000001001001001000010100110
11111111111000100110010110010100
00000000000110110010011100111101
11111111111100011010001111011010
00000000001011110110100000110100
11111111111101000001111001010001
00000000001001010100101110000000
00000000100101101000100101110110
00000000000001111010001111100110
11111111110011110011101010010100
00000000000000100101110111111001
00000000000000011111111011000010
00000000000011001011111011111100
11111111111110001010100110010011
11111111110000000011000011011000
00000000000101110011110110010010
00000000010111110111000110110001
11111111111100000101110010010011
00000000010110111100001010001101
00000000000110101011111011100111
11111111100110111100001010101000
00000000000001110010101111010011
00000000010101111101110011010010
00000000001000111000110011000100
11111111010010011100101011001101
11111111110011111001110011100011
00000000010110111001001001111101
11111111011101111001010101111111
11111111111100101000000100001110
11111111111111111001001111011111
11111111111010000110111110110100
11111111110000001110111111011010
11111111111100000010110010010101
00000000000001001110101001001010
11111111110011101100100001110101
00000000001110110101000100000100
11111111111110000111101111110011
00000000000010100111101000001111
00000000000110001101100001110110
00000000011001100010001010010110
00000000101011111001111100110001
11111111111011001010001111011000
00000000001110101100101000011101
11111111110110110100101101110100
00000000101001001001100010110011
11111111111011100010001001100101
11111111110000101111001101010011
00000000001000010011110000011011
11111111111100011101110001001110
00000000001111101010100110010011
11111111111000000011101111011010
00000000000001010101001000010101
00000000000001110010100000110101
00000000010101011100110100110011
00000000010001101001110100000111
11111111111101100111011011100011
11111111111001000100010000000000
00000000010010100100011101000101
11111111110111010011101011000100
11111111111111000110011010100101
11111111110111000011001110011101
