1111111101110001
0000000011111111
0000001100110010
1111111100000110
1111111100100011
1111111010110011
0000000000101001
0000000110010110
1111110000000001
0000001100011001
1111110101001011
0000001000111010
0000000011010000
0000001111100110
1111110000010110
0000000000000110
0000000110010011
1111111010011001
1111111010101000
1111111100100111
1111111110111001
1111111111000000
1111111100000100
1111110110000101
0000000110001101
1111111100011010
0000001010001111
0000010101110100
1111111011000000
0000000011000011
1111111101000010
0000000011110010
0000000010100001
0000000111010001
0000000010100100
0000000101011010
1111111110010001
0000000100111111
0000010001001011
0000000000011000
1111111111001011
1111110101001001
0000001001110001
0000000011111110
1111111100000000
0000000101111100
0000001001111010
1111111101111110
1111111001010111
0000000001000111
0000001001101110
1111111111000001
0000000110011111
1111111100001010
0000001100110000
1111110101001101
0000000001101011
1111111100111100
1111110001011001
1111111111100100
0000000110010100
1111111110110111
1111111100100110
1111110111010010
1111110110101101
1111111111100010
1111101111010001
0000001101010100
1111111010001100
1111111010111101
1111111101001110
1111110111010011
1111110111101011
0000000010001100
0000001010100111
0000010110100000
0000000000101010
0000001011110010
1111111111100111
1111111010001111
1111110001001111
1111111111100001
1111111110111011
0000010010001000
1111111101111000
0000000001001111
1111111110110011
0000000101111111
0000001011111000
0000000111001110
1111111110011010
1111110001110000
0000000001010010
1111111101000111
1111110110101111
1111110101010111
0000001011010001
0000001000111010
1111111110111001
1111111110110010
1111111000111100
1111111110001111
0000001010111110
1111111101011101
1111111100011011
0000000011101000
0000000100111101
1111110001000010
1111110100101110
1111110111010100
0000000111101001
0000001101001001
1111111010110011
1111111010101011
0000001111111111
1111111000001110
0000001110011100
0000010000000001
1111111101001001
0000001100111101
0000001111101010
1111110100000110
0000001011011110
1111111010110010
1111110010010010
0000000000010111
0000000001011001
0000000111010101
1111110011011111
0000001110101010
1111110101100001
1111111010110100
0000001010010101
0000001100101001
0000000111110100
1111111000111011
0000000010010000
1111111101000001
0000001111001101
1111111010110010
1111110101011110
0000001000010011
1111111010110101
1111110111100011
0000001100010111
1111111110100110
0000000111111101
0000000100100110
0000001100110011
0000000101111111
1111111011111100
1111111101010010
0000000001001110
1111111110001111
1111110110101110
0000000100111001
0000000111110011
1111111011000011
1111111010110000
1111110011111100
0000000001011101
1111110001111000
1111111000100101
1111110101010110
0000000000010001
1111110101111101
1111101101000110
1111110001000101
1111111100101100
1111111000000001
0000000011010101
0000000000111010
0000000101101100
0000001111010001
1111111111110011
0000000011001111
1111111010000001
0000000000100000
1111111000010001
0000000101000100
1111110100100111
1111111111101011
1111110010000110
1111111110011010
1111110000010010
0000000110110111
1111111001010100
0000000001100111
0000000010110011
1111110110001001
1111111101110100
0000001010010110
1111111101100111
0000000110100101
1111111001000011
1111111110111111
1111110101000101
1111111111001010
0000010110111101
1111111110100010
0000000011001000
0000010011010101
1111111011110111
0000000111001000
1111111010100101
0000000101001110
1111111100110010
1111111101100011
0000000010010111
0000000101010001
0000000001011010
1111111110001111
0000000000010111
0000000100100010
0000001001000110
0000000001011100
0000000111000100
0000000001010010
1111110110010010
0000010000011010
1111111010101000
0000000001111100
0000000100101110
1111111001000111
1111111111111111
1111111000011001
1111110111000001
0000000110110111
1111111110101001
1111100111010000
1111111000101111
0000000101010100
1111111110000110
0000000110010101
0000000010001011
1111111101100100
0000000001111001
1111110101000110
1111111100101110
1111111110000011
1111111101000111
1111111110110001
0000001111000010
1111111100100011
1111111111111011
0000010111000000
0000001100100110
0000000100000010
1111110100110010
1111110000110100
0000001000000100
1111110001110010
0000000001100010
0000001100110100
1111111011110010
1111110001101111
