0000000010101101
0000000010001010
1111111111111011
0000000000001110
1111111110101001
1111111111011011
1111111111111111
0000000100100001
1111111100101100
1111111110110000
0000000011011100
1111111010010100
1111111100101111
0000000100000011
0000000010001101
1111111111111101
1111111100011010
0000000000001000
0000000001011100
0000000000100110
1111111100010100
0000000010110010
0000000001010000
0000000000011010
1111111110010010
0000000000011001
1111111111100000
1111111101100001
0000000000100111
0000000001101000
0000000000100011
1111111110110110
1111111111100111
1111111111100101
1111111010110101
1111111111111111
1111111111001010
0000000100110010
1111111100110000
1111111110000100
0000000001110111
1111111100111110
1111111111111011
1111111110010000
0000000010110111
1111111101000010
0000000010110001
0000000011011110
1111111110110100
1111111101100011
0000000010010100
1111111110101001
0000000000110011
0000000010000111
0000000011001001
1111111110101101
1111111101110100
0000000100001000
0000000010000110
0000000000110010
1111111111100110
1111111111101100
1111111101001010
0000000100010100
0000000010010000
0000000001011001
1111111101110110
1111111110101001
1111111101010100
1111111111011000
0000000001001100
1111111111010000
0000000000001111
0000000000101011
1111111101111011
0000000000011011
1111111101011011
1111111111010000
1111111111111111
0000000000010010
1111111100011011
1111111100010011
0000000000101111
1111111111111011
1111111101100110
0000000001100000
1111111101101010
1111111100000100
0000000000011101
0000000000010010
1111111111011101
0000000101000100
0000000011011011
0000000000101110
0000000000011111
0000000010011000
0000000000101100
0000000010101110
1111111110010010
0000000001101100
1111111101000011
1111111111110000
0000000001001001
1111111010011000
1111111111100010
0000000000100001
1111111100100000
1111111110101101
0000000010000100
1111111101000100
1111111110000010
1111111101111110
0000000100100111
1111111110011001
1111111111101001
0000000001001111
1111111101111000
0000000010101100
1111111101011110
1111111110001010
1111111111001111
1111111110010011
1111111111100011
0000000100011111
0000000010011001
1111111111101010
1111111100111001
1111111010010000
0000000010011110
1111111111000101
1111111110110010
1111111111011011
0000000001100101
1111111110100001
0000000001101011
0000000010001111
0000000010101111
0000000000101101
1111111101101111
1111111111000101
0000000001111101
1111111100101100
1111111111000011
0000000000001000
1111111111011000
1111111111010011
0000000001110010
1111111010110111
0000000011001110
0000000100101000
1111111100110110
0000000000000100
0000000000111111
0000000010100000
1111111111010101
0000000000100100
1111111110010000
1111111100110101
0000000010001110
1111111101001101
0000000100001100
1111111111111100
0000000010010000
1111111110100100
1111111111111110
1111111101010010
1111111110110010
1111111110011010
0000000000111100
0000000000000011
0000000010011000
1111111101110001
1111111101100100
0000000000001010
0000000000101100
1111111101000010
1111111110100111
0000000010111001
0000000001010001
0000000000010111
1111111111010010
1111111110011000
1111111011101010
0000000000001100
1111111101010101
0000000001111001
1111111111001101
1111111101101001
1111111110010001
0000000000011001
0000000010110111
1111111100100111
0000000001111010
1111111101100100
0000000000000000
1111111110111010
1111111100110000
0000000000111110
1111111101110110
0000000001000000
1111111111001010
1111111111001011
1111111111101000
1111111111110111
1111111111101111
0000000000110101
0000000100100101
0000000000010111
1111111110101101
1111111111011101
1111111111000011
0000000000010011
1111111111110110
0000000010011011
1111111101011000
0000000001100011
1111111110000110
1111111010110001
1111111110011000
0000000000110101
1111111111000111
1111111111111111
1111111110010101
0000000100010101
0000000001100011
0000000001111100
1111111111100011
1111111110010110
0000000101000100
0000000001100011
1111111111110000
1111111101010001
1111111111101000
0000000010111000
0000000010000010
0000000001101010
0000000000010111
1111111111111010
1111111111011111
0000000001111000
0000000000001100
1111111110100000
0000000011111110
0000000000001110
0000000010100111
0000000001001111
1111111111101011
1111111110011111
0000000000110001
1111111100100100
1111111111111101
1111111101110110
0000000000011010
0000000001110110
1111111110111010
0000000101010110
