00000000000000011111101111101001
11111111110101111110101110111001
11111111110011011010010101111110
00000000000100001000010000111111
00000000000010101100010011101100
00000000101011000111110011100101
11111111110111001011001101000111
11111111110010110001111101001010
00000000001111111000010001001010
11111111010110011001111011001011
00000000010001010100110001111111
11111111110110010001000101101010
00000000001010111111000101001011
11111111110111000001001100010111
00000000001000110110110000110010
11111111110110110111101110011101
11111111111111010100011000001001
11111111111100010011000101000111
11111111110100001110100111000100
00000000101011010011000000000101
11111111111110010000000110111110
00000000011010000001111011101111
11111111111101111100011111011001
00000000000011001110100111111100
11111111011110001001010111101100
00000000001101100000011100000101
00000000100011110101010000100111
11111111111111100000100100101110
11111111110101101000001111011011
00000000000011100100100101100101
00000000011110111101111101001110
00000000010110101011100000100001
11111111110110011011110110100100
11111111100011001000110111110110
11111111111100100000001001001010
11111111100100000000010011000101
00000000011011100111101011001000
11111111011101101001010011011101
11111111010111001110001100110001
00000000100001000101010001000101
11111111010110011011011111101011
00000000101011111110000011001011
11111111111111101111101000001100
11111111111110111111011110110010
11111111111100100101011010111010
11111111111001000110111010100111
11111111101001001010010011111011
11111111111010001100010001011100
11111111001001101001000100000110
00000000010000000001101011001110
00000000011001100101101110010110
00000000000111000110110010011001
11111111101111011011100000000010
00000000000101101001010001100011
11111111000010011011000111101111
00000000010000000110000010011011
11111111101000000010011010000011
00000000010001001111000100000001
11111111101100110010110110011100
00000000000000111010101111000000
11111111111110100000000000011100
11111111110111000110101001110001
00000000010111000010010101010101
11111111111001010111111101111100
00000000000011110101101010000100
11111111111001011000100001000010
11111111110000000011011000101000
11111111111011000101010111001001
11111111100110111110000110010100
11111111011000111001011000000000
00000000010100000110100110111000
11111111110110101111001110100010
00000000110111010110010100100110
00000000100101110100011101101111
11111111110111101010100010001001
00000000100010110001000000101101
00000000011000110011000000110000
00000000010100101001011000111111
00000000011101110001001001101001
11111111110100000100001110011000
11111111011000000000010011101110
00000000001110110101101011000010
00000000001110110010100100010110
00000000000110010011010011010001
11111111101010011011110011111000
00000000001111001110100011011100
00000000011111100001100010010000
00000000001011100010011010111010
11111111101000001001101110100100
11111111101001010111011110111101
00000000010000100000101000111001
11111111110010000001010010111101
11111111100101110101010101011000
00000000011000101001011000010101
11111111011011111101101111101111
00000000010001000100010100111000
11111111010110110101011001110000
00000000100011111000011111000000
00000000010111101110100101010001
00000000000111100011110001010010
11111111111011000111000101011100
00000000000011100111011011000101
00000000011011001010111110001011
11111111110011101000010010111001
11111111111111110000011000100101
11111111110101010100111111111111
11111111101000001011000101111110
00000000010011111001110011111110
11111111110110011111100110100101
11111111010011000111100011110101
11111111101010010110010001101010
11111111111001001000110010001110
00000000010111000011111100010000
11111111110100100010000011101000
11111111011111011110100000100101
11111111110110001100010000010000
00000000011111100100101000111100
00000000010110101110100001110011
00000000000000000101110110100101
11111111110010111110000000110001
00000000000110100111011110011011
00000000000000011001100011100001
11111111100010011100100011100000
11111111111100111010111111111000
11111111111011001010110010101011
00000000001011110010000100100011
11111111100001000101110000001010
11111111101100001100101000111000
11111111101001100000010110111111
11111111111100100111110101101100
11111111110000111010011111001010
11111111100010011001010101010111
00000000010101010110011000000110
00000000001100111111101110110110
11111111011111111111101101001011
00000000001010010011111100001011
11111111100010110110010100101110
11111111110111010111010100010110
11111111011011101011011101100010
00000000001011011000001000111111
00000000000010110111101100010111
00000000010011011100001101110010
00000000000000011111101001101100
11111111111101111010000100010101
00000000001100110000101111011111
11111111110101101011111110100000
11111111110101000100000100001110
00000000101111010001001100100111
11111111110110001110000101000010
11111111110111011010110000100000
00000000100101000100101111010001
11111111101001110011011010101111
11111111111110000000010000011000
11111111010011110101101111100010
11111111101001100111000101101110
00000000000101010000101011000111
00000000010101100001001100000101
11111111100000011110110010101100
11111111011011111100110001101000
00000000000001000111011000110101
11111111100011110010111001001100
00000000101001101010000110001000
00000000000111010111100001111110
00000000000011101001100110111111
11111111111101101110111110111010
11111111111011101000010111101110
11111111101100000111110100001000
00000000001101010011000000011111
11111111100000100111100100111111
11111111101111001111000110101000
00000000000001101010110100100001
00000000001111001101111111101010
11111111110101110010100100001011
11111111111010111101101110010000
00000000011000110110100000100000
11111111110001010110110111010010
11111111111010001000111010001100
11111111111011000000110111000000
11111111110111011010101100101000
00000000100101111000010011110111
11111111010010000101110110101100
11111111110011001111100010011110
00000000010100110110000111100100
00000000010100100001011101100101
11111111110010110110000111101001
11111111111010011001011010010000
00000000110110000000101001010101
00000000110000000000010111100100
00000000001111101010010011111111
00000000001010011000101100010100
11111111110101100111000110101000
00000000111101011110000101010110
11111111111011001010110000001010
11111111010101011101001111100000
00000000000001000101000011010001
00000000011101111000001001101010
11111111111000010001010100000110
00000000000100000100011001001101
11111111111101000010101110011111
11111111100100010000000100111111
11111111110111101101111011010100
00000000001010110101111011011000
00000000101011110010011111011000
00000000110111011111110101100011
00000000000000011110010111111011
11111111110101010101000110000010
00000000100001000110101111001100
00000000001000001111001100001001
11111111111110110101100011100100
11111111110111001011101111011100
11111111110010110100100001001011
11111111110100011001111011100010
11111111111000111011011000100010
00000000001001100000100000101101
11111111111011110001110000010101
00000000110011011100111100101001
00000000000010010101110111001110
00000000000111110011100000101000
00000000011111011110101100010100
11111111001100010100101001101001
11111111100111001000111100101101
00000000001011110110101001110000
11111111011111111001000110111000
11111111111110001000101011101111
11111111111011011011011001000100
11111111101101110111100110110010
11111111110011101111000000001100
00000000001110101101100110011011
00000000010000101100100001111000
11111111001110110000011011110000
00000000011011000101000000100111
11111111101111101100111100100010
11111111111011111010000000101001
11111111111010100110001111010011
11111111110110100111101110100000
00000000100011110000110000101110
11111111110111100101001001000100
00000000100110011101111010101000
11111111101101011001011101000110
00000000110100110010111011010011
00000000000100010111000101111010
00000000000110010110010110110110
11111111101100101110111110101000
11111111101001010111111110001111
11111111110001110000110000011100
00000000011000101000100111111010
00000000000010100101000111100001
00000000001100100010100011000100
00000000001001010101001111110101
00000000010001110100110100011001
00000000111100011100100110001100
00000000110100000011001000110100
11111111111110101111010101101100
11111111110110111011010110010010
00000000000000001111111110100010
00000000011101100000001010010011
