11111111111110001010110100001011
11111111111111111101010110111111
11111111111110110011101110110101
00000000000000000101000000101110
00000000000010010000110001110011
11111111111111101111010010111101
11111111111110010010101110000010
11111111111111111100000011011110
00000000000000111101011100111001
00000000000001101000000001000110
11111111111111111110001000010110
11111111111111011110100000110001
11111111111111100111111011110001
00000000000000111101101110110011
11111111111110111010111101110110
11111111111111110001010111111000
00000000000010110101011101100001
00000000000001111001011101100001
00000000000001100111001110110001
11111111111101110001111101110111
00000000000010011001001001101000
00000000000000010110010100110101
00000000000001101111110011010110
11111111111111011111011011110011
00000000000001010111000101010111
11111111111101001000001001100101
00000000000001000111000111111111
00000000000001011011100011100100
00000000000000010001111010100111
00000000000001001101111000110000
00000000000001110000101000101111
00000000000001011100111111101110
11111111111100110100101011000001
11111111111111001100101100000001
00000000000000110000100101010111
00000000000001000100010011110010
00000000000000111010011100110011
00000000000010110101001100101000
11111111111110111011000110011001
00000000000010000011101001010100
00000000000001010011100000100000
11111111111110110101101100111100
11111111111100110000010101010110
00000000000001001001101101100011
00000000000000001010011111011110
00000000000001010011010011000111
00000000000001101000110110110101
00000000000000011000101101000100
11111111111110101101101001001001
00000000000000011110110110111100
11111111111110110000111101001100
00000000000000110101000000101000
11111111111110110111100111001100
11111111111110110110010001110001
00000000000000101101001001000111
00000000000010010101101110110111
11111111111110001011001011011100
00000000000001110101111100111101
11111111111111101110001010010101
00000000000001100010000010111110
00000000000000011001111010000000
11111111111100100111000101101000
11111111111110111001011110111110
11111111111101110111111101110101
11111111111110100001110110000111
00000000000000110110100001111011
00000000000000011100010110110101
11111111111101010111111101011100
11111111111101101100010001001001
00000000000000010110010110101111
11111111111111011111000110011010
00000000000001101111111011011000
00000000000001100011011101000011
11111111111111011011100111001010
00000000000000011011001000011010
11111111111111111110101100100111
00000000000001101100000101110101
00000000000000000001011110000111
11111111111110111001111010101110
11111111111111110111100000110000
00000000000001010111001011011111
00000000000000001110101000010101
00000000000000011101010111000001
00000000000001000110111111110001
11111111111111100111000100110000
00000000000000010101100001001011
00000000000000101100000001010000
11111111111111011010010001101011
00000000000011011100001000000101
11111111111111110010111011000101
00000000000000100110111110001011
11111111111101101100100111100100
00000000000001010101110010010011
00000000000000100110100001101000
11111111111111011100000001111011
11111111111110110010001010001100
11111111111111101000101011110101
00000000000001010100001010010001
00000000000000001111100101111011
00000000000000001110010100010000
11111111111111100010001010111001
00000000000010010100011010001100
00000000000000101100110011000011
00000000000001001011111111101110
00000000000000110010101100101100
00000000000000000010001001001100
11111111111101110110011101011110
11111111111110011100000011100101
11111111111110001001010100000100
11111111111111110111101000101011
00000000000000101110010011010011
00000000000001001101100100111000
11111111111110101100001000100111
00000000000000110000000000101010
11111111111111101001000000111110
11111111111100111111000111001100
00000000000001111001000111011100
00000000000010000100011011000111
11111111111110111010010111110011
00000000000011111000001011111011
00000000000000011010100111101000
00000000000001011001110001101001
00000000000010001010111111110101
11111111111111000000101111100010
00000000000011011001010100010110
11111111111100011010111000101100
00000000000000100101100001000100
11111111111101010101101111110101
00000000000001010100111110110101
11111111111101111100010000111100
00000000000001100111101111000001
11111111111110001100000011001011
00000000000000010101110000001011
11111111111110010110110000001100
11111111111100110100101101000010
11111111111111110100011001000001
11111111111111110000110011001011
11111111111101100001000111100111
00000000000000000011101100010010
11111111111111100100110001010101
00000000000011001110000000100011
00000000000000000111100001010000
11111111111111011101111010010110
00000000000000010111110111001000
00000000000000111001101111010001
11111111111110010101101001101110
11111111111111010110101111100111
11111111111111111010011011110001
00000000000000100100011110101110
11111111111101000111000111101111
11111111111111110110111011111000
00000000000000011010100000111011
11111111111111110100010000000010
00000000000000110000101000011011
00000000000010110001010001000000
11111111111100011100011111010001
11111111111111001110101101001011
11111111111110001110000000111100
11111111111110011100000011101100
00000000000001101111111101111000
00000000000001110100101111100010
00000000000001110111111001000111
00000000000000101001111000111100
11111111111110011000011110000001
11111111111111010000000111101011
00000000000010010101010100000100
00000000000001000111000010101111
11111111111110111001010110101101
11111111111110011100101000001010
11111111111110011110101100001101
11111111111110101000100001110110
00000000000001111010110011110100
11111111111111111010110010010011
00000000000101101011111111101010
11111111111111110010001000100110
00000000000000111101111111000100
00000000000000101100100010011010
11111111111101101010100110110000
00000000000001001110111101000011
11111111111101111111001101110110
11111111111111110100001110100100
11111111111110011011101011110110
00000000000001100011000001010010
11111111111101110111100000000000
11111111111111111110010101100000
00000000000010010001001110101110
11111111111100100110000010000001
11111111111110010100001100100101
11111111111111011100110110101011
00000000000010000001000100101111
11111111111111011101110101111001
00000000000000010010011111100100
00000000000000010110110100100101
11111111111111010101010101001100
00000000000000001101001010110111
00000000000000100000100001110001
11111111111111111001111001010001
11111111111110101100010100110000
00000000000001010111001101101000
00000000000011010100101010100011
00000000000000011000111000001111
11111111111110101110001100110011
11111111111110000001000110101010
00000000000011110111001100110101
00000000000001100000110011101001
00000000000000111111100110000110
11111111111110110101110000100110
00000000000001000100110010011010
00000000000001001101000001101011
00000000000001011010010010110000
11111111111111011100010111000101
11111111111111111001101110011111
11111111111111001011010101011100
11111111111111100011100101100011
00000000000001100111100001110100
11111111111111101010100100101111
00000000000010001100110111100010
00000000000001111011110100111001
11111111111111011000100100100110
00000000000000011000101101010001
11111111111110000001111101011101
11111111111110100110011100000100
11111111111111111011000111010000
11111111111111111011010111000100
00000000000001110011101101000100
11111111111111111101011111100101
11111111111110010011110100000000
00000000000000001000011001101111
11111111111111111110010010010101
11111111111100110010110110111000
11111111111111000101110010010111
00000000000000101101101000001011
11111111111101111111000101100100
00000000000000000011011010001001
00000000000000100110001110100010
00000000000000100010000000100110
00000000000000010010100000000101
00000000000000111001110101110100
11111111111101101010111011001110
00000000000000001001001111001010
00000000000000101011010101111010
00000000000000001100101011001110
00000000000001100000110110000101
00000000000001000111110010001110
00000000000001000100110110101110
00000000000001001110010001101000
00000000000001110100101000001010
11111111111111010000000100111010
00000000000000101111011100010100
00000000000000011000100001011110
00000000000000000101111010101101
11111111111110111011100000100101
00000000000000000010100011000001
00000000000000011001101100110101
11111111111111101111010111110011
11111111111101000101001100000000
