1111110100011110
0000000011010110
1111111011010100
0000001011001000
1111111010001101
1111110100111101
1111111100010000
1111111010011111
1111100110000000
0000010010111001
0000000000001100
0000100001111000
1111111110100001
0000100001000011
1111101111111010
1111110111111101
1111110111010111
0000000000111110
1111111110011001
0000001001001000
0000001011101000
0000000001011010
0000000001001100
0000000100100111
0000010001010011
1111110100010010
0000001011100100
0000010110010110
1111101100011000
1111111111110111
1111111011110110
0000000010010011
1111111010001100
1111111101010110
1111111001111001
1111110110101111
0000000111011011
0000000100100111
0000000010101111
1111111110011010
0000000011101011
1111110110101010
0000000111011000
0000001110111101
0000000100010111
0000001100110111
1111111001011010
1111101110000011
0000000000100101
0000001001010101
1111110111111011
1111111101011001
1111111101001111
1111110001001001
0000001100001111
1111101001110100
1111110100011100
0000001000111100
1111101000011000
0000000010011110
0000010110101011
1111111110011010
1111111011110111
1111101111110110
0000000111000100
0000000100101000
0000011110010000
1111101101000100
1111111110111001
0000000000101001
0000000101000010
0000010010001101
1111111010000010
0000000101111001
1111101010001010
1111101111111100
0000000111111111
1111111110001001
1111110000110010
0000001000001111
0000010101001111
1111110011110100
1111110110110111
1111110000000110
1111110010001010
1111111100100110
1111110110111100
1111100111100011
1111111011000111
0000000100100010
0000001000111010
0000010101010010
0000001001101000
0000000110001111
1111111110001110
0000000101010001
0000001010110110
0000010001001100
0000001011001111
0000010100000101
1111110101000111
0000000101010111
0000011111100111
0000000010010110
1111111010101011
1111110011101000
0000001100001010
1111111000111111
1111110011101001
1111111111000001
0000011010011010
0000001101111001
1111110010001001
1111111000111001
0000011011100001
0000000000101001
0000001111101111
0000000111001011
0000001101010001
0000000000100110
0000001110111010
1111110000111100
1111111010011010
1111111100101010
1111110101111101
1111111111010100
1111111101010101
1111111110101110
1111110001000110
0000010100111101
1111101111000101
1111111000011010
1111111111100010
0000001011011011
0000011010010011
1111110010010111
0000000100100110
0000010000001000
0000001110110010
1111111000110111
1111110011011110
0000001100001110
1111111000101011
1111110001101000
0000001110100000
1111111001000001
0000001001110111
0000000001100101
0000010101101000
1111111110101111
0000000010010101
0000000110101110
1111111100111010
1111110101010110
0000000001110110
0000001001100110
0000000100000100
1111111101111010
1111101111001000
1111111001110110
1111110000001100
1111110001111001
1111110101010011
1111110101010100
0000010101011010
0000000100001010
1111101100000000
1111110101101010
1111111101011110
1111110110100011
0000001101100101
1111111100011011
0000000100100110
0000000111111110
1111111010110010
0000000010011111
1111111110001000
0000001011010011
1111100101110001
0000010010100111
1111111000000110
1111101011100011
1111100100011101
1111111100100100
1111111101101101
0000010100010100
1111110101000111
0000010000111001
0000000001101101
1111101000010000
0000000010001011
0000011000000000
1111110101111000
0000001000010111
1111111011111101
1111111101001110
0000010101001000
0000001101110111
1111110101010101
1111111111011111
1111111111111010
1111101001111010
0000001111101000
1111111100101101
1111110111011110
0000000100011000
1111111100111111
1111111101011110
0000001010001110
0000000100001011
0000000110000011
0000000111100111
0000000011111110
0000001101001111
1111110101100011
1111110011110110
0000000101100010
0000000111001000
1111101011100110
0000000000001100
0000001011100010
1111111000001100
0000000110011000
1111101110000010
0000010010101110
1111110001110111
1111111011110111
1111110101011000
1111101011001000
1111100111110000
1111101110001100
1111101100100000
1111111011111010
1111111001011111
1111111001000101
0000000101011001
0000000110110010
0000010110100100
0000000100110100
0000000011111111
1111110101111010
1111110101101101
0000001010110001
1111110111100001
1111110001001000
0000010011110011
1111111111101111
0000000000010000
1111100010110111
1111111001011010
1111111101100001
1111110010010101
0000000011111001
0000000100000010
1111111001011101
1111111100101100
