00000000000000000101001001000111
00000000000000000111110101100011
11111111111111110110101101010001
11111111111111111000010001100111
11111111111111111110100000111000
11111111111111111011111011011010
11111111111111111100100011101000
00000000000000010100100010001100
00000000000000000001001111000011
11111111111111110110101000110001
00000000000000000110111101110110
11111111111111101110001010011110
00000000000000000010001110001000
11111111111111110101101100100100
11111111111111111110011110001110
11111111111111101111011111111110
00000000000000010010110000000111
11111111111111111011000111101011
11111111111111110011101001111001
00000000000000000001110111100111
11111111111111110110100100110010
00000000000000000111111100001110
11111111111111111110101110100000
11111111111111110110011010110110
00000000000000000011111000101001
11111111111111110001001100001101
00000000000000001101011000100100
11111111111111110100100011100010
00000000000000000011100110111001
00000000000000000010110011100001
11111111111111110000100110000001
11111111111111110100110110111111
11111111111111100100001001001111
00000000000000000010011101000101
11111111111111111101000001101001
00000000000000000001100110010011
11111111111111100000100000111111
11111111111111111111100101111111
11111111111111111101100101100101
11111111111111100100111110010001
00000000000000011001010101000101
11111111111111111001110010001011
11111111111111110100010010000010
00000000000000000101000100000000
11111111111111110010101001011001
11111111111111111001111001110111
00000000000000000000100011000001
00000000000000011001110111100101
00000000000000001100001001100111
11111111111111111010000010101011
11111111111111111111110110111001
00000000000000000100100100010101
00000000000000000011000000100000
11111111111111110001010111011110
00000000000000000010101010010010
11111111111111110010010011110010
00000000000000000001100100010000
11111111111111110101010011101100
11111111111111111110110111000110
11111111111111110010011111111110
00000000000000001111011011111101
00000000000000000001111101111101
00000000000000001011010000001100
00000000000000010010101110011000
11111111111111111111111110000011
00000000000000001001010011001111
11111111111111110010111000000010
11111111111111110100111111001100
00000000000000000000101111011011
11111111111111111101001111100101
00000000000000001010000101100001
11111111111111111111100000000011
11111111111111101011010000100000
00000000000000000111111011111010
11111111111111101000101011010101
11111111111111111111000011010001
00000000000000010010010010101110
11111111111111110011001010011100
11111111111111110111111100011011
00000000000000000100000111111001
00000000000000000010101000010000
11111111111111110100101000010000
00000000000000000110010000001011
00000000000000001110100010110011
00000000000000011001010100010000
00000000000000000000001001111100
00000000000000000000101100001111
11111111111111101010001001101001
00000000000000000111100011010101
00000000000000010000101000010101
00000000000000000111100110011001
00000000000000010011010000010001
00000000000000010000000110001111
00000000000000001110011010010101
11111111111111101001101100011101
00000000000000000110100011101111
11111111111111110101001001001000
11111111111111111100001111001010
00000000000000001011000000101101
11111111111111111011110100101111
11111111111111111111011001110100
11111111111111100010010101000000
11111111111111111010100100111110
11111111111111101010011010100010
00000000000000001100100011110101
00000000000000000011110101111101
00000000000000000110101110100000
11111111111111111000101101101100
11111111111111111001011000100101
00000000000000001110000010111101
11111111111111100111000101110110
00000000000000000011101000101010
11111111111111111000100000001011
11111111111111111100110010001011
11111111111111110011010011011000
00000000000000001011010110110110
11111111111111111011111110111111
00000000000000001011111110100011
11111111111111111100100110100000
11111111111111101101101101110010
11111111111111111000100001100110
11111111111111111001111100101110
11111111111111111010000000111011
00000000000000011000111101101111
11111111111111101010001000000000
11111111111111110111001000000110
11111111111111111110101101111111
11111111111111101010001110110111
11111111111111110000111110111001
11111111111111111001011010010101
00000000000000001101110010010111
00000000000000000001010111111101
11111111111111110100011110011011
11111111111111111100010100111111
11111111111111111000010100001011
00000000000000001111000100000101
11111111111111111000001011010111
00000000000000010111110110011101
00000000000000010000010101101101
11111111111111111001100000000011
11111111111111110110011010101111
00000000000000000001110110111001
00000000000000001011110001011101
00000000000000001101110001110111
00000000000000000010001101001101
11111111111111101011011101010011
00000000000000000000001001101000
11111111111111101110001000110100
11111111111111111101001100001100
00000000000000011001001011111110
00000000000000000111011010110101
11111111111111101101101010001101
11111111111111101111110011111100
11111111111111110010101000010110
11111111111111101000010110100011
11111111111111111000010011101011
00000000000000001110100000101010
00000000000000000100010101110100
11111111111111101111000110101011
00000000000000000001100010101101
11111111111111111001100100100011
00000000000000010111011111011011
11111111111111101000000110010001
11111111111111111010100010100001
11111111111111111100001010111110
00000000000000000100110000101000
11111111111111111010110111000000
00000000000000000100011010010100
11111111111111101010101111010101
00000000000000000100001110100011
00000000000000001000111001110000
11111111111111110110101101010010
00000000000000000001011000110010
11111111111111111101011010110110
00000000000000010000001101001101
11111111111111110011100000110001
00000000000000000010011011000010
00000000000000010000110101011100
00000000000000001101100011000111
11111111111111110101110011010011
11111111111111110111001100101110
00000000000000000111011011000010
11111111111111100111100001101101
00000000000000000111001110110111
00000000000000000010000100100001
00000000000000010111000001100001
11111111111111111011011101001100
11111111111111101110111011110100
11111111111111111100011111110110
00000000000000000101111111101100
00000000000000000000111011111001
11111111111111110000101111000001
00000000000000000000101110111001
00000000000000000100010001110011
11111111111111110010011111001001
00000000000000000101011010101111
11111111111111110000100010101001
11111111111111111001001100011001
00000000000000010110010001011001
00000000000000000000001011010001
11111111111111111010001001000111
11111111111111101010001000000111
11111111111111110100111010100110
00000000000000000010101100110110
00000000000000011001000100100000
11111111111111111001110111100000
11111111111111110111110110000101
11111111111111111110000110011101
11111111111111111000110011101111
00000000000000000000011011100011
11111111111111111111001010110000
00000000000000000011100001011110
00000000000000000000011100111000
11111111111111101100000010010010
00000000000000000111100001111110
11111111111111111100011111110110
11111111111111111001110100101001
00000000000000010111010011001111
00000000000000000101100011001110
00000000000000011000011001101100
00000000000000001000001001010100
11111111111111110101010000001100
11111111111111110100110110101011
00000000000000010001100001101011
00000000000000000011100101001011
00000000000000010100011110111011
11111111111111111011110111101101
11111111111111110001011000011001
00000000000000001101001011011110
11111111111111101101101111010100
11111111111111110101111000100001
11111111111111101110101101100101
11111111111111111001011001001101
00000000000000010010001100100101
00000000000000010000010110111011
11111111111111111011000111111001
00000000000000000101010111100011
00000000000000001010101011010011
11111111111111101110001001111100
00000000000000000111111001110000
00000000000000001110011001001011
11111111111111111000000010000011
00000000000000001011001101110011
00000000000000000110111100110101
00000000000000000100100101011110
11111111111111111100111010001010
11111111111111110010110010100000
11111111111111110101000000110100
11111111111111110000111011101000
11111111111111111010011110101110
00000000000000000101110000101000
00000000000000000101000001001000
11111111111111101010010010100011
11111111111111111011011100010001
00000000000000000101000110100011
00000000000000001110001000111001
