11111111111111101101110111001110
00000000000000100000100000110100
00000000000001100111010101011111
11111111111111100001111010110010
11111111111111100100101111011111
11111111111111010101110011111000
00000000000000000101101111100011
00000000000000110011001010000110
11111111111101111111001100010100
00000000000001100011110001111001
11111111111110101000110101100001
00000000000001001000000000100101
00000000000000011001111010111001
00000000000001111101111000101010
11111111111110000001111101011000
00000000000000000001010011011001
00000000000000110010010101011111
11111111111111010010111111111111
11111111111111010100111101011110
11111111111111100100110010001001
11111111111111110111110101110010
11111111111111110111110000101101
11111111111111100000000110110110
11111111111110110000110100100100
00000000000000110001111110111000
11111111111111100010111111011111
00000000000001010010010010001010
00000000000010110000010000100111
11111111111111011000000010100111
00000000000000011000000111010010
11111111111111101000100000001111
00000000000000011110000011001000
00000000000000010100000111110010
00000000000000111010001101000010
00000000000000010100100010010001
00000000000000101100010111011000
11111111111111110001110001100001
00000000000000101000001110011110
00000000000010001001100101010101
00000000000000000010110111101010
11111111111111111001011001010000
11111111111110101001001000101001
00000000000001001110111100011011
00000000000000100000000111000111
11111111111111011111000101101011
00000000000000101111010011010010
00000000000001001110111101001000
11111111111111101111111000111001
11111111111111001010111011111101
00000000000000001000011110111111
00000000000001001110011101011110
11111111111111110111010010101001
00000000000000110100000110100010
11111111111111100001010011101001
00000000000001100101001100010110
11111111111110101000110011010100
00000000000000001101100010001000
11111111111111101000001000011011
11111111111110001010011010100110
11111111111111111100001110100001
00000000000000110010101110100001
11111111111111111000011001100110
11111111111111100101001001010101
11111111111110111001110111111110
11111111111110110101010110001100
11111111111111111100101100001100
11111111111101111001011011100000
00000000000001101011111100011101
11111111111111010000111111001001
11111111111111010111000001101010
11111111111111101001111100111000
11111111111110111010010010101111
11111111111110111101100000110111
00000000000000010001001001100101
00000000000001010101111110000011
00000000000010110101001100000101
00000000000000000101001110001000
00000000000001011110110110010110
11111111111111111101100010100100
11111111111111010001101000101111
11111111111110001001101010001000
11111111111111111011011000100001
11111111111111110110010101001110
00000000000010010001111111001101
11111111111111101111001000111110
00000000000000001001011001011011
11111111111111110101111110001111
00000000000000101111100110001010
00000000000001011111101000011011
00000000000000111010011001000001
11111111111111110011110010010101
11111111111110001101001110000001
00000000000000001010011100010100
11111111111111101000110001000000
11111111111110110101001011001101
11111111111110101010000100101110
00000000000001011010000000011010
00000000000001000111100101000100
11111111111111110110011011101000
11111111111111110110101000110101
11111111111111000110010110001101
11111111111111110001000011101010
00000000000001011000000101100100
11111111111111101011001011001111
11111111111111100011000110001101
00000000000000011101000000001101
00000000000000101000000111110111
11111111111110000111101110000111
11111111111110100100100001001010
11111111111110111010010110111110
00000000000000111101100111100110
00000000000001101001101101111011
11111111111111010110010111001110
11111111111111010100111000011011
00000000000010000000101111010110
11111111111111000000100110010001
00000000000001110100000011000000
00000000000010000001101010011101
11111111111111101000101100000001
00000000000001100111101011101100
00000000000001111101110000101101
11111111111110100000100011110001
00000000000001011100100111111101
11111111111111010110010111100011
11111111111110010001011100001110
00000000000000000011100100010000
00000000000000001011000010010101
00000000000000111011011101010100
11111111111110011010100110100110
00000000000001110110100101000100
11111111111110101011110100110110
11111111111111010111100011100100
00000000000001010011101100011010
00000000000001100101100110101001
00000000000000111111100110011110
11111111111111000111100100001110
00000000000000010010010010110001
11111111111111100111100110000011
00000000000001111001100001000111
11111111111111010110001111111010
11111111111110101011010000100101
00000000000001000010011110110000
11111111111111010110110001111100
11111111111110111100000001100110
00000000000001100011100100110111
11111111111111110100010011011011
00000000000000111111110100011010
00000000000000100100010110101111
00000000000001100111010100011000
00000000000000101111101001000000
11111111111111011110101100010100
11111111111111101001110110001111
00000000000000001001100111111000
11111111111111110001101010100101
11111111111110110101010110111010
00000000000000100111011100010010
00000000000000111110011000101100
11111111111111011000010101100011
11111111111111010101011111100000
11111111111110011110101111011000
00000000000000001011011010111010
11111111111110001101111000100000
11111111111111000011111110011000
11111111111110101010010111100110
00000000000000000010011000010000
11111111111110101111011100001111
11111111111101100110110110000000
11111111111110000111110010110100
11111111111111100101101110001111
11111111111110111111100111110101
00000000000000011010110001110111
00000000000000000111011011001000
00000000000000101101100111110001
00000000000001111010100101111100
11111111111111111101011110010110
00000000000000011010101110010000
11111111111111001111011110000001
00000000000000000011010100111101
11111111111111000010001010010000
00000000000000101001011010000011
11111111111110100100001010011010
11111111111111111101110111100100
11111111111110010000000001101110
11111111111111110011100111000011
11111111111110000001110001100000
00000000000000110111100101001111
11111111111111001010101000000000
00000000000000001100100010110000
00000000000000010111000000110010
11111111111110110001001111101101
11111111111111101110001010011110
00000000000001010011101111111110
11111111111111101101001100010001
00000000000000110101101001111110
11111111111111000111101000101101
11111111111111110111111111101011
11111111111110100111001110100000
11111111111111111001000011000111
00000000000010111001010110100000
11111111111111110100111011000100
00000000000000011001011010110011
00000000000010011010111010000100
11111111111111011110011010101010
00000000000000111001000001000010
11111111111111010100111011000001
00000000000000101001111100000100
11111111111111100101111010010001
11111111111111101011111011101011
00000000000000010010111001000101
00000000000000101011000001111010
00000000000000001011111110100011
11111111111111110001010011101101
00000000000000000010100011001100
00000000000000100101010001000100
00000000000001001010000011110000
00000000000000001010111101000110
00000000000000111001011011101000
00000000000000001011001110100111
11111111111110110010010001001010
00000000000010000011011010111111
11111111111111010100011101010011
00000000000000001111100000011010
00000000000000100110000111001111
11111111111111001000000110000000
11111111111111111111011110110001
11111111111111000010111000110000
11111111111110110111111011110001
00000000000000110111011010110001
11111111111111110101010101011010
11111111111100111000001111100011
11111111111111000100100100010010
00000000000000101010010010110110
11111111111111101111111100101011
00000000000000110010111001100100
00000000000000010000101100011010
11111111111111101101000001000000
00000000000000001110110010011111
11111111111110100111101011101110
11111111111111100101010111110011
11111111111111110000110011010011
11111111111111101000011101010001
11111111111111110101111010110000
00000000000001111000011100010011
11111111111111100100000000110011
11111111111111111111010110001110
00000000000010111000101110000010
00000000000001100101000110000110
00000000000000100000011010101000
11111111111110100101011100000010
11111111111110000101110001110001
00000000000001000001111001101110
11111111111110001100110110101011
00000000000000001100100111111001
00000000000001100111111111111100
11111111111111011110001100110101
11111111111110001101101111000010
