00000000000101000010110000111100
00000000000000010001101010011111
00000000000011011010011010110101
00000000000010001111000110101001
00000000000010100111100100111101
11111111111010101010100110010100
11111111111101110101011001101101
11111111111111011011100110001101
11111111111001001001011110001110
00000000000111000111111111001011
11111111111000111000010100011111
11111111111001100011111001000011
00000000000010111100001010001111
11111111111010111000000000110101
11111111111010000100000110001010
11111111111010111010101011001110
11111111111110100001001011011000
11111111111101000111011110011011
11111111111000111101001000100000
11111111111100111001011100100101
00000000000000110000101000111101
11111111111010010101010110011100
11111111111101110011110100001000
11111111111000010010011011101010
11111111111011101001111110111111
11111111111111110100010001101000
00000000000001001010001111010111
11111111111100011011100110001101
00000000000001101010001000110011
00000000000000101101010000101100
00000000000101100110001001001101
11111111111010100001010001111011
11111111111001111111010101011010
11111111111010110100011011011101
00000000000101001011101011000111
00000000000100011100000110111101
11111111111110101100011111100011
11111111111001000001010001111011
11111111111110000001000001100011
00000000000110110011000010111110
11111111111100111101010010010110
00000000000110100101110010010001
00000000000001011000111111000101
00000000000010100001101111011010
00000000000110001000011100101011
00000000000101001011000011110010
00000000000111001000110000010101
11111111111001000000111110010001
11111111111101010011001100110100
00000000000100111111010010000111
11111111111011011001110011100001
11111111111101100011101011111100
00000000000100110010011000010111
00000000000011001000110000010101
11111111111111000001101000110111
11111111111100001101111110100101
00000000000100110111110000011011
11111111111010111111100101110011
11111111111001011111101001000100
11111111111101111011110000000010
00000000000000110010110010100101
11111111111000101100101100101010
00000000000111011100011010100111
11111111111101011000101000001010
00000000000000001011101011000111
00000000000000000110011001100110
00000000000011111100010100000100
00000000000100111001010010101111
11111111111101000110110011110101
11111111111111110110010111111110
11111111111100101101100111101001
11111111111011011100110100110110
11111111111111001100000101010101
11111111111101000011011110110101
00000000000001010010000100101101
00000000000011011010010000111111
11111111111100111000101110101101
11111111111101110111000101110110
00000000000001101110010010001110
11111111111001001010001100000110
11111111111001010110001110001001
00000000000000111110111110011101
11111111111011100010001100111010
11111111111011110000111100101000
11111111111000110010001110100011
11111111111101101011011010101111
11111111111111010111000010100100
00000000000000100010011010000000
00000000000101010011110100000111
11111111111010100000010011101011
00000000000100100000100111010100
11111111111101011100000110111110
00000000000111000011000111111000
00000000000000110110111111010010
00000000000101110001111110001010
00000000000000001000110011100111
00000000000011011011111101001000
11111111111010100011101000101010
00000000000001000010001001101000
00000000000011110101101010000101
11111111111000010001100111001111
00000000000100000101001110001110
11111111111101111010000111001011
11111111111001110101101101011000
11111111111011001101100111101001
11111111111100110001100000101011
00000000000110111010111110110111
11111111111111001001100100110001
11111111111011000110101101010001
00000000000101000110001111110001
00000000000001101001010001000110
00000000000110011101110011000110
00000000000011111011100110001100
00000000000100101011111000001101
00000000000101001000011100101011
00000000000100110101010011001001
11111111111100001011100001010010
11111111111010011100001101100010
11111111111101010100111000111100
00000000000011011100011101111001
00000000000001100100000010110111
11111111111011111111011000101100
11111111111100110001011101011001
00000000000010100111110101010110
11111111111001001000000010011110
00000000000101011011000101011011
00000000000110111101110110010111
00000000000100000101000100011001
11111111111111101110001110111101
00000000000010110000010101010011
00000000000110101101000011100101
00000000000000101110101100011100
00000000000100000010010110101110
00000000000010100000101010100110
11111111111111101000101001110010
00000000000000001000011001011001
00000000000000010000111100100111
00000000000000101110010010001110
00000000000111000011110010011110
00000000000011000010001001101000
11111111111101110010001000000000
00000000000100001110100010100111
00000000000001011110011101101100
00000000000100011000111011110011
11111111111011010010111111101101
00000000000111000001011000011110
00000000000001110111100011010100
11111111111001010100110101101011
00000000000100110010010001110100
11111111111011010110111100000001
00000000000111111101101001010001
00000000000100110110000100010011
00000000000011011001011001010010
11111111111101001100111001110001
11111111111100011011000101011100
00000000000110111011110110100101
11111111111010011111011011111110
00000000000110011100101011000000
11111111111101000110100011011100
11111111111010111000110101010000
00000000000100111100111011011001
00000000000111111111100101110010
00000000000111101011000011110010
11111111111100001111100100001010
11111111111010011000101011011011
00000000000011000111101011100001
00000000000011010101110111001100
11111111111111000010110000111101
00000000000001001010011001001100
00000000000101100000100000110001
11111111111101101000001100010011
11111111111111011000111111000110
11111111111011011011110110100110
00000000000001000110100000001001
00000000000000011111101100010101
11111111111001010000000001101001
00000000000011001001000111010001
11111111111100100111001110000010
00000000000000001101100001000100
11111111111010011100111011011010
11111111111001011101000101001111
11111111111100010101001100100111
00000000000111100000000000000000
11111111111111101100110110011111
11111111111100000000001101000111
11111111111100111111000001110000
00000000000000110111100011010100
11111111111011011011101001011111
11111111111110000110001100100000
00000000000100001010000101100001
11111111111100100101101000011101
11111111111010001010010010101001
11111111111110010101001111111000
00000000000101011101101001010001
00000000000100000111000111011110
11111111111111101110100101111001
11111111111100100010100111001000
11111111111000100100001100101101
11111111111111010110011011010000
11111111111110011011001011111111
11111111111101110010110101111000
11111111111111101101100001000101
00000000000010000000100100000010
11111111111101000001100101100110
00000000000101100001111100100001
00000000000011001001010111101001
11111111111011110010111111101101
11111111111010011101100010101110
11111111111101011100010111010111
11111111111101111110001101010100
11111111111001010011010000000101
00000000000110000011000001010101
00000000000001001110111001100011
11111111111001001100110011001101
00000000000001011000110101001111
00000000000011100100101101011101
11111111111000000000111110010001
00000000000000111010001010011100
00000000000101100101100101001010
11111111111001110111010110001111
00000000000001110000101100001111
11111111111001000100100011101001
00000000000000000110000101111100
00000000000001100010101101101010
00000000000001011011011001000101
00000000000000110101110000101000
00000000000110110001010011100011
11111111111101001101010000101101
00000000000011101010111001111101
00000000000110000010000011000100
00000000000110101010110110101011
00000000000100000011111100010100
00000000000110001100010101101101
11111111111101000110010110010101
11111111111110100011001110011101
11111111111100100101101111000001
00000000000001101010011001001100
11111111111110000011010101000000
00000000000111100111001010110000
11111111111010001000111101011101
00000000000010111001010010101111
00000000000101011100101110010010
11111111111011111111001011100101
11111111111100011010010001000000
00000000000010000010111010110001
00000000000010100100010011010000
00000000000001110111010110001110
00000000000100000111110010000100
11111111111011000100000110001010
00000000000110010101111101101111
11111111111100011000101000001010
00000000000101001111110111110011
00000000000110100000001001110101
11111111111000000111101011100010
00000000000111101101000011100101
11111111111011010000101111100001
