00000000000000000110011111010101
11111111111111111110101001110010
11111111111111110111011111011100
11111111111111111111001101110101
11111111111111111101001110001001
00000000000000000001010010101111
00000000000000001000100010111010
11111111111111110100000000101110
11111111111111111011111011111010
00000000000000000101010011001001
11111111111111111010100100001010
00000000000000001100011001101100
11111111111111111011111101010110
00000000000000000110010000110010
11111111111111110110111111000110
00000000000000000111011111001000
00000000000000000110111011111001
00000000000000001011110100001110
11111111111111111010110000110000
11111111111111111000111001001001
11111111111111111111010000100000
11111111111111110111010100010010
11111111111111111010100100101011
00000000000000000100001001110101
11111111111111111010100010011011
00000000000000001001010110001110
00000000000000000000111110000011
00000000000000001100011010100001
00000000000000000011001101001101
00000000000000000000011001101100
11111111111111110010101110100000
11111111111111111101110111100001
11111111111111110011010011001010
11111111111111110000110110000101
11111111111111111111010011111110
11111111111111111101101101101011
11111111111111110000000011011111
11111111111111110000011101100000
11111111111111110001010001111011
00000000000000001100010011101010
00000000000000001001100011101000
00000000000000001111110001011101
11111111111111111100101011000001
11111111111111110111100111000001
11111111111111110110010001101000
11111111111111111100010111110001
00000000000000001101001101010011
11111111111111110011010101101110
00000000000000000011000110001001
00000000000000001001000011011110
00000000000000000010001101100111
11111111111111111101101001010010
11111111111111111010001011111111
00000000000000001000110100100001
11111111111111111010011111000010
00000000000000001000001011010000
11111111111111111011011011111110
00000000000000000110001000010010
11111111111111111000101011100010
00000000000000000110001011100100
00000000000000001000101100111101
00000000000000000110101111000000
00000000000000001110111111010010
11111111111111111100010000111010
00000000000000000100101000101001
11111111111111111011010101011010
11111111111111110011111011100111
11111111111111111110111100011011
11111111111111111110111111100000
00000000000000000001101111111011
00000000000000000100110010110010
00000000000000000101010010101111
11111111111111111001100110001101
11111111111111110001101010010011
11111111111111110011110111010011
11111111111111110100110100000010
00000000000000000010101110100101
00000000000000001111100100001001
11111111111111111110000010001010
11111111111111111001111010010001
11111111111111111011101000010000
00000000000000000111000000000000
00000000000000001010011001011111
11111111111111111011110110101100
00000000000000001100101111000110
00000000000000001100100101001010
11111111111111110101011010111100
00000000000000001011010001010011
00000000000000001100000101110101
11111111111111111011011101100000
00000000000000001101011011010101
11111111111111111010001011000100
00000000000000001111010000010010
00000000000000000000110101111101
11111111111111111000001000000110
11111111111111110001100100010111
11111111111111111000101100001001
11111111111111111100011100111111
00000000000000000011011010101110
00000000000000000111100101111111
11111111111111110000110111011010
00000000000000001110100010011010
11111111111111110010011111110000
00000000000000001000000101001110
00000000000000001000001100111001
00000000000000000100010110111100
11111111111111111111101110000110
00000000000000000111000000011010
00000000000000000011101101110001
11111111111111110101101010110100
11111111111111110101010111010000
11111111111111110001101110100110
11111111111111111010101001001011
11111111111111111101110111000000
11111111111111111111010101000111
11111111111111110011111110010001
00000000000000000011111110110001
11111111111111111000000000001110
11111111111111110101001010001001
00000000000000000111011100010111
11111111111111111001001111001010
11111111111111111111010010011100
00000000000000001001011111010101
11111111111111110000100001100110
11111111111111110000101000000011
11111111111111111001011111111101
11111111111111110100011110011011
00000000000000001010001111100100
11111111111111110101001100100111
11111111111111111011110010010010
00000000000000000111100101001010
00000000000000000110001101001101
11111111111111111000011001101101
11111111111111111100000100101110
00000000000000000011101100001000
11111111111111110100101000000011
00000000000000001000000000111010
11111111111111110000001010011101
00000000000000000100111010111000
00000000000000001011011010110101
11111111111111111100001000110100
11111111111111111010010001111011
00000000000000001100110001101010
11111111111111111110111111110011
11111111111111110110110101010000
00000000000000001011010111111101
11111111111111110111001001001110
00000000000000001001000000011010
00000000000000001011001100000101
11111111111111110010000000000111
11111111111111111010100010100001
00000000000000001100111000010100
11111111111111110001001110001001
11111111111111111110100101110011
11111111111111110000010101000111
11111111111111111000000001011100
00000000000000001001011011001111
00000000000000000101000101011011
11111111111111111000010100101100
11111111111111110110110001111111
00000000000000001000100001111111
11111111111111110001000010100100
11111111111111110001010100011001
11111111111111110110110001111000
00000000000000000000011101110011
11111111111111111011101101001011
11111111111111111111101000101010
11111111111111111011001110010110
11111111111111110111011110111100
11111111111111110011010000011001
11111111111111111111110011100001
00000000000000001001000110001111
11111111111111111111011001110100
00000000000000000001111110111110
00000000000000000001110110111111
00000000000000001110010110001110
00000000000000001001101000001111
11111111111111111000110010110011
00000000000000000001101011001101
00000000000000001011110111111010
11111111111111111111010011111000
11111111111111110111111000110110
11111111111111110111011000010010
11111111111111110000001001011011
00000000000000001100100011000001
11111111111111110101100001100000
11111111111111110101001100100000
00000000000000000110010000101100
00000000000000000001001111110001
11111111111111111011010000000101
11111111111111111000110101011101
00000000000000001000000110011100
00000000000000000010100000010110
11111111111111111110001110100011
11111111111111111011111100111100
11111111111111110110100010001101
11111111111111110100110111100001
11111111111111111011101011001000
00000000000000001011001110010101
00000000000000001011000011000100
11111111111111110010001000100111
00000000000000001000000000100000
11111111111111111011110011101110
11111111111111111001000110111000
00000000000000001001011110000000
00000000000000001111100110100000
11111111111111111010111110010001
11111111111111111100110111110100
11111111111111111100100111101001
11111111111111111100001100000110
00000000000000000001010110000111
11111111111111111101110100101001
11111111111111110110001111100101
00000000000000001010001101010011
00000000000000000010000000111010
00000000000000000101100001000100
00000000000000001000100011111100
11111111111111110001010000101101
00000000000000001110111110011101
11111111111111110110100100110001
11111111111111111110101100110000
00000000000000001001011100100100
00000000000000000011001100001011
11111111111111110001101010100000
00000000000000001100000010000011
11111111111111110111100011001000
11111111111111110110101000000011
00000000000000000101001111101010
11111111111111111101011101011001
00000000000000001111101110000101
11111111111111110010010011000011
00000000000000000011100101011110
00000000000000000101110010111001
11111111111111110011100110010100
00000000000000000101101111011010
00000000000000001010100111100001
00000000000000001000000001011011
11111111111111111101010110001000
11111111111111111011000001110110
11111111111111110011001000000110
00000000000000000011001101100111
00000000000000001011001011100100
00000000000000001001000101010100
00000000000000000010001000011111
00000000000000000000101111110100
00000000000000000011110101101010
11111111111111110011111001101010
11111111111111111110111000110110
11111111111111110101101101001011
11111111111111111011001110011101
00000000000000000101011000111000
00000000000000000000010111110000
11111111111111110010110111011010
11111111111111110111011011001001
00000000000000001001100111101110
11111111111111111011011110110101
