1111111010110001
0000000100100111
0000000000101101
1111111011011100
0000000011000111
0000000110110011
1111111111011100
0000001001111111
0000000111111011
0000000000000111
1111111110101011
1111111110101110
0000000101000001
1111111101000111
0000000000111000
1111111100101111
1111110111100111
1111111110101111
0000000000110110
0000000010100000
1111111100011110
0000000010111111
0000000000010100
0000000110101101
1111111001110101
0000000010000011
0000000100000010
1111111110100110
0000000011101110
1111111100101111
0000000000100100
1111111010100101
0000000011011111
1111111110011001
1111111010011001
1111111010110001
1111111101001010
1111111011000101
1111110111001010
0000000100100011
1111111010000011
0000001010101001
0000000010100001
0000000100111001
0000000011110000
1111111010001101
1111110111010000
1111111011101111
1111111101000001
0000000001110111
0000000101001010
1111111100111100
0000000001010001
1111111100101100
1111111110010000
1111111011101110
0000000010001101
1111111101110001
1111111111011000
0000000101101100
1111111010110001
1111111001111000
0000000110011110
1111111100001110
1111111101001110
0000000000100110
1111111011000000
1111111100101010
0000001011101101
0000000000101010
1111111011100101
0000000000000010
0000000001111010
0000000001010010
0000000011000010
0000000010100010
1111111110001011
0000000011000010
1111111101110001
1111111011010110
1111111101111001
1111111001100111
1111111001100101
0000000010000101
1111111100001011
1111111001010100
0000000001001001
1111110111010000
1111110110001001
0000000001011101
0000000001110011
0000000010111001
0000000001011111
1111111100110100
0000000110011011
0000000011011110
1111111111010101
0000000010010101
1111111010011110
0000001100110010
1111111101010100
1111111100000100
1111111101110111
1111111010001011
1111111100001001
0000000110100001
0000000000111000
0000000101001100
0000001001111110
0000000101111110
1111111111111011
1111111010100111
0000000100000111
1111111111110001
0000000011100000
0000000110000110
0000000101100001
1111111110101011
1111111111100110
0000000001100001
0000000000110111
0000000000110111
1111111011111100
1111111010101110
0000000111111101
1111111010010001
1111111111100010
0000000010100111
0000001000101111
1111111100101101
0000000010010010
1111111100001000
0000000000001000
1111111000100011
0000000011001110
1111111111111011
1111111111010111
0000000000000111
1111111100001110
0000000000000000
0000000001101010
0000000110111101
1111111001011010
0000000001101001
0000000001110101
0000000001011111
1111111101100110
1111111011000010
0000000000110100
1111111111010001
1111111111001000
1111111100110000
0000000011010111
1111111110000111
0000001000100010
1111110111010000
1111110111100000
1111111110010101
0000000001111000
1111111100011010
0000000010101010
1111111011100000
0000000111001111
0000000000001101
0000000111111011
0000000011101010
0000000101001000
0000000001110110
0000000101101010
1111111110001010
1111111100111111
1111111111110101
0000000000100001
0000000010011100
1111111111101010
1111111000011000
1111111001011111
1111111110101111
1111111100100001
0000000001110001
1111111111010011
0000000010010100
0000000101100101
0000000010100101
0000000010010011
0000000000101011
0000000010000111
0000000000000101
1111111111010111
0000001001110110
0000000000110111
1111111101000001
1111111101100011
1111111111001010
1111111101110011
0000000001110001
0000001001010110
1111111110101110
1111111011011011
0000000001010110
1111111111110001
1111111110001100
0000001011100101
1111111100001001
0000000000111110
1111111010001100
1111111011001101
1111111100011000
1111111011110000
1111111101110001
1111111111010010
1111111100100001
1111111110100100
1111110111100100
1111111101011100
1111111110100000
0000000001010110
0000001000110101
0000000000100110
0000000100100101
1111111111001010
1111111111101010
1111111110111000
0000000001100110
0000000110100110
0000000001011000
1111111110011010
1111111110110011
1111111001110001
1111111101110000
0000000000100111
1111111001010001
0000000110101000
0000000110111100
1111111010111000
0000000101110111
1111111111001101
0000000001101100
0000000100010011
1111111011011101
0000000011111110
1111111100010101
0000000110101101
1111111000100110
1111111100101011
0000000011100101
0000001001100100
0000000010000010
0000000001101000
0000000011101111
1111111100111001
0000001001101110
1111111110011111
1111110110010111
0000000010101110
1111111100100010
