1111110001011011
1111111111001010
1111110110010001
0000000000010110
0000010001101111
1111111101101111
1111110010010001
1111111111010111
0000000111011111
0000001100101111
1111111111110000
1111111011100101
1111111100110111
0000000111100111
1111110111011000
1111111110000111
0000010110100110
0000001111000011
0000001100101101
1111101110001101
0000010010111100
0000000010101101
0000001101110000
1111111011110011
0000001010110110
1111101001001010
0000001000111010
0000001011010111
0000000010001101
0000001001110010
0000001101111100
0000001011100000
1111100110100111
1111111001101000
0000000101111010
0000001000100100
0000000111001000
0000010110011010
1111110111010111
0000010000010011
0000001010001111
1111110110110111
1111100110001111
0000001001001101
0000000001010010
0000001010011001
0000001100111101
0000000010111111
1111110101110010
0000000011110010
1111110110001011
0000000110100110
1111110110111001
1111110110110101
0000000101100001
0000010010100011
1111110001011101
0000001110110000
1111111101101111
0000001100000101
0000000011010011
1111100101000110
1111110111011001
1111101111001000
1111110100010101
0000000110110000
0000000011101001
1111101011001010
1111101101110001
0000000010111011
1111111100000001
0000001110000001
0000001100010101
1111111011100001
0000000011100100
1111111111110111
0000001101011011
0000000000001001
1111110111010000
1111111110111011
0000001010101110
0000000001110111
0000000011110001
0000001000110001
1111111100110110
0000000010101111
0000000101100110
1111111011010101
0000011011011010
1111111110010100
0000000100110100
1111101101110001
0000001010101011
0000000100111100
1111111011100100
1111110110011000
1111111101001001
0000001010100010
0000000010000000
0000000001110000
1111111100011000
0000010010101000
0000000101100011
0000001001100001
0000000110010001
0000000000010101
1111101110111101
1111110011011111
1111110001010100
1111111111000011
0000000101101011
0000001001100111
1111110101100010
0000000110001000
1111111101001011
1111101000001000
0000001111001101
0000010000011011
1111110111011101
0000011111000001
0000000011010111
0000001011001110
0000010001011011
1111111000011011
0000011011000101
1111100011111000
0000000100110111
1111101011010000
0000001010100100
1111101111001111
0000001100101111
1111110001010010
0000000010100111
1111110010110100
1111100110100101
1111111110010101
1111111110000001
1111101100001100
0000000000011001
1111111100011011
0000011001100101
0000000000111000
1111111011101010
0000000010110111
0000000111001100
1111110010110011
1111111010111010
1111111111001100
0000000100011000
1111101001000110
1111111110111000
0000000011001101
1111111110101000
0000000110000110
0000010110000001
1111100011110000
1111111001110001
1111110001110101
1111110011100010
0000001101110010
0000001110011100
0000001110111010
0000000101010000
1111110011001101
1111111010001001
0000010010011011
0000001000110011
1111110111001011
1111110011101000
1111110011110010
1111110101000100
0000001111011000
1111111111001101
0000101101010011
1111111110010100
0000000111110000
0000000101011000
1111101101011110
0000001001101100
1111101111111111
1111111110100110
1111110011100110
0000001100010010
1111101110111110
1111111111110101
0000010010001001
1111100101000000
1111110010100101
1111111011100100
0000001111111111
1111111011110011
0000000010010010
0000000010110110
1111111010101111
0000000001101001
0000000011111110
1111111111010001
1111110101100110
0000001010110101
0000011010010111
0000000011000011
1111110101110110
1111110000011101
0000011110100111
0000001100000101
0000000111110110
1111110110110010
0000001000101001
0000001001100110
0000001011001011
1111111011011100
1111111111010010
1111111001011110
1111111100011000
0000001100101110
1111111101011111
0000010001100000
0000001111001110
1111111010111111
0000000011010000
1111110000010101
1111110100111011
1111111111010110
1111111111011100
0000001110011010
1111111111101100
1111110010100100
0000000001000111
1111111111110011
1111100110100011
1111111000111111
0000000101110001
1111110000001100
0000000000011100
0000000100111110
0000000100010110
0000000010010101
0000000111010111
1111101101101000
0000000001001100
0000000101011110
0000000001101000
0000001100000010
0000001000111111
0000001000110000
0000001001111100
0000001110101100
1111111010000110
0000000110000011
0000000011001011
0000000000111000
1111110111101011
0000000000011010
0000000011100001
1111111110001101
1111101001001100
