00000000000000000000111111100000
00000000000000101101010110111011
00000000000000111101111011111000
00000000000000000111001001000101
11111111111111101011010000100000
11111111111111111111000001001011
00000000000001000111101010011100
00000000000000011011000000111000
11111111111110111100010010110010
00000000000000000110011101010001
11111111111111111011111000111110
00000000000000110100000011110110
11111111111111111100100000010010
00000000000001010110100101111110
11111111111111101000011101010000
11111111111111111000100110001001
11111111111111111110101000101110
11111111111111101101101111011111
00000000000000010001101101011110
11111111111111101110000010011001
00000000000000010101111110001010
11111111111111101100100010001011
00000000000000100010101001100110
11111111111110101100110011111100
00000000000000011111110000100000
11111111111111100101100011111101
11111111111111101110010110011000
00000000000001010110001111100100
00000000000000000101011000100100
00000000000000001000010000011100
11111111111111100110110100110010
11111111111111101011111101100011
11111111111111101100110111101110
11111111111111110010101111111111
00000000000000101110000100100100
11111111111111101110001101001111
11111111111111111101000000000011
00000000000000000001110101011111
11111111111111011001100101101111
00000000000000100010011110000010
11111111111111010000000100110100
00000000000000100000001100001000
11111111111110000100110110010111
00000000000000001011010010100110
11111111111111011110110111000010
00000000000000001110001101100110
00000000000000110011001011010111
00000000000000100000000011010010
11111111111110010011010010001100
11111111111111110100011000100101
11111111111111010010010100101110
11111111111111110010001101111001
11111111111111111001001010110101
11111111111111111101111110111011
11111111111111111111011111010011
00000000000001010111111100000100
11111111111110101100110111000010
00000000000001000010001010100000
11111111111110101110011100011011
11111111111110111011010010101010
00000000000000110111001111010110
11111111111111001000000000100100
11111111111111111001000000010011
11111111111111000110010001110000
00000000000000000111101011010011
00000000000000100010001000101000
11111111111110110111111011100100
00000000000000110001010010101001
11111111111111001011101010101011
11111111111111100100000010101010
00000000000000100001000001001110
11111111111111010010101110111111
11111111111111010000010011100010
00000000000000010111000100111001
00000000000000111111000010111101
00000000000000011110011101000110
11111111111111010100110111101001
00000000000000001100100110101010
00000000000000011101100101000101
00000000000000011101101011010101
11111111111110110000000000101011
11111111111111101000001000011110
00000000000000111011100010010010
00000000000000101001010010101111
00000000000000110001100101111111
00000000000001000101100001111100
11111111111111101111010101001000
00000000000001001011101000111011
00000000000001101110101100100100
11111111111111101101011110011001
00000000000000101000001101001001
11111111111110110001110010110010
11111111111111001101111100010001
11111111111111110110001010101000
11111111111111100000000110110001
11111111111111110010110001000001
11111111111110101101101010111001
11111111111111011000011001001110
11111111111111000010001011100011
00000000000000010111100100000110
11111111111111110110010101101000
11111111111111111001110101111101
11111111111111000100111001001010
00000000000000000000110011000110
00000000000000001101001110111111
11111111111111100101111100000101
00000000000000000000001011101110
00000000000000101101011101000110
00000000000000111111001001001101
11111111111111101100011000100011
11111111111110111110111101000101
11111111111111101001000100001010
00000000000000101110000111110101
11111111111111110010010001100100
11111111111111010100101100100011
11111111111110100110001111001100
11111111111111101100111111001100
00000000000000100111110011100111
11111111111111010000010110010010
11111111111111101010101010000010
11111111111111111111100000101111
11111111111111100111010000101001
00000000000000110110010101111100
00000000000000000111001110111000
11111111111111110110001110001011
00000000000000001111000111100001
00000000000000101111011101000111
00000000000001000111110000110110
11111111111111010011000000110000
00000000000000000010001110110010
11111111111110110111111001100111
11111111111111000000111101100101
00000000000000101011000010010101
00000000000000001010100001011100
11111111111111010011001110001111
11111111111110100111101011100001
11111111111111111100000000100000
11111111111111010011100110111100
00000000000001001010001001011111
11111111111111101110110101100001
11111111111111101100011100001011
00000000000001011110100010010110
11111111111111101010001000001001
11111111111111101011010111111011
00000000000000011001100001011100
11111111111111111011110100001100
00000000000000000000111111010101
00000000000000100110111000011001
00000000000000000101101111011001
00000000000000010110110000010010
11111111111110110111010111000001
11111111111111101110101110101001
11111111111111000101101100101100
00000000000000010100100111111010
11111111111110111111111111011101
00000000000000011001111111100001
00000000000000101010101100101111
11111111111111000100110010101000
11111111111111100001110100111111
11111111111111111001001111101011
11111111111111000111100101110110
00000000000001111010111100000010
11111111111111101011001110001110
00000000000000010100110001010110
00000000000000011111010100100010
00000000000001100000000000101110
00000000000001101100000001001100
11111111111111110100110010110001
11111111111111100101101100010001
00000000000000101001000010110111
00000000000000101001101100001101
11111111111111100110011111000100
11111111111110100100001011110000
00000000000001001011110000101001
11111111111111101110110101011100
11111111111111110110000001110010
11111111111111110100010001110110
11111111111111100010101101110010
00000000000000110001101100111100
11111111111111110101111011011110
11111111111111101011100101001100
00000000000000011110011011111010
00000000000000000011010101101000
11111111111111011110011110010001
11111111111111000001001111001011
00000000000000011010100110000001
11111111111111011000001111101001
11111111111111110111010000110100
11111111111111111011011101111010
00000000000000000111010011001011
00000000000000001110101111000000
00000000000001010011010100001000
11111111111111110110010101100001
11111111111111111100010001010111
11111111111110111111110010001111
00000000000000010111101101001110
11111111111111001110010001111101
11111111111110011000101001010101
00000000000000111110111101011001
00000000000000001111100110111101
00000000000000000100101011101111
00000000000001100110111001110100
11111111111111110111100011100010
00000000000000010011000001000001
11111111111111110001110110110000
11111111111111101000110011111001
11111111111111100101101001000010
11111111111111101110010111011111
11111111111111111101101011001011
00000000000000010000011110010101
00000000000001000010001101011011
11111111111111101010101010010000
00000000000000000000111100101101
00000000000001101110111111100011
00000000000001010111100100111011
00000000000000010101101011110111
11111111111111101111011011110101
11111111111111001000100000001100
11111111111111111010000101011100
00000000000000001000001000110101
11111111111111110000100010100110
00000000000000111011110000001011
00000000000000000010001010000010
11111111111110101010111010100001
11111111111111110110110110110000
00000000000000111011000000010001
00000000000000000000011111111110
11111111111111101101110110101100
11111111111111111101011110101011
00000000000001101000000110001110
00000000000001111000111001000011
00000000000000100011101001100110
00000000000000010010101010011100
00000000000000011001000101001000
00000000000000000101001010010001
00000000000000110001010001001110
11111111111111100011100001100010
11111111111111010010101111111110
11111111111111011001011101111110
00000000000000001100101100101101
00000000000000001000101110001100
00000000000001101001100101110001
11111111111111011010110010111100
00000000000001001100111011110110
11111111111111101111001010010111
00000000000001000111100001100100
11111111111111101101001111100001
11111111111111110101001100100100
11111111111111110111110100000100
11111111111111011111011001111010
00000000000000110110001001111101
11111111111110011101100000111100
00000000000000100001011001000000
00000000000000011101011011001100
11111111111111100111011110000110
11111111111111011011101111001101
