0000000000101001
0000000000111101
1111111110110110
1111111111000010
1111111111110100
1111111111100000
1111111111100101
0000000010100011
0000000000001010
1111111110110110
0000000000111000
1111111101110010
0000000000010010
1111111110101110
1111111111110011
1111111101111101
0000000010010101
1111111111011001
1111111110011111
0000000000001111
1111111110110110
0000000001000000
1111111111110110
1111111110110100
0000000000011111
1111111110001011
0000000001101010
1111111110100100
0000000000011100
0000000000010110
1111111110000101
1111111110100111
1111111100100010
0000000000010100
1111111111101001
0000000000001101
1111111100000101
1111111111111101
1111111111101101
1111111100101001
0000000011001010
1111111111001110
1111111110100011
0000000000101001
1111111110010110
1111111111010000
0000000000000100
0000000011001110
0000000001100000
1111111111010000
1111111111111111
0000000000100011
0000000000011000
1111111110001100
0000000000010101
1111111110010011
0000000000001101
1111111110101011
1111111111110111
1111111110010101
0000000001111010
0000000000010000
0000000001011010
0000000010010100
0000000000000000
0000000001001010
1111111110011000
1111111110101000
0000000000000101
1111111111101011
0000000001010000
1111111111111100
1111111101011011
0000000000111111
1111111101000110
1111111111111000
0000000010010001
1111111110011001
1111111111000001
0000000000100001
0000000000010110
1111111110100110
0000000000110010
0000000001110100
0000000011001001
0000000000000001
0000000000000110
1111111101010010
0000000000111100
0000000010000100
0000000000111101
0000000010011001
0000000010000000
0000000001110100
1111111101001111
0000000000110101
1111111110101010
1111111111100010
0000000001010111
1111111111011111
1111111111111011
1111111100010011
1111111111010100
1111111101010100
0000000001100011
0000000000011111
0000000000110110
1111111111000110
1111111111001011
0000000001101111
1111111100111001
0000000000011101
1111111111000101
1111111111100111
1111111110011011
0000000001011011
1111111111100000
0000000001011110
1111111111100101
1111111101101111
1111111111000101
1111111111001111
1111111111010000
0000000011000110
1111111101010010
1111111110111010
1111111111110101
1111111101010011
1111111110001001
1111111111001011
0000000001101101
0000000000001011
1111111110100101
1111111111100011
1111111111000011
0000000001110111
1111111111000010
0000000010111110
0000000010000010
1111111111001100
1111111110110101
0000000000001111
0000000001011110
0000000001101110
0000000000010001
1111111101011101
0000000000000010
1111111101110010
1111111111101010
0000000011001000
0000000000111100
1111111101101110
1111111101111111
1111111110010101
1111111101000100
1111111111000010
0000000001110011
0000000000100011
1111111101111010
0000000000001100
1111111111001101
0000000010111011
1111111101000010
1111111111010100
1111111111100001
0000000000100101
1111111111011000
0000000000100100
1111111101010111
0000000000100001
0000000001000111
1111111110110111
0000000000001011
1111111111101101
0000000010000000
1111111110011100
0000000000010100
0000000010000110
0000000001101011
1111111110101111
1111111110111011
0000000000111011
1111111100111110
0000000000111010
0000000000010001
0000000010110111
1111111111011100
1111111101111000
1111111111100100
0000000000101110
0000000000000111
1111111110000111
0000000000000110
0000000000100010
1111111110010101
0000000000101011
1111111110000101
1111111111001001
0000000010110001
0000000000000001
1111111111010010
1111111101010010
1111111110101000
0000000000010110
0000000011000111
1111111111001111
1111111110111111
1111111111110001
1111111111000111
0000000000000011
1111111111111001
0000000000011011
0000000000000011
1111111101100001
0000000000111100
1111111111100100
1111111111001111
0000000010111001
0000000000101100
0000000011000010
0000000001000001
1111111110101011
1111111110100111
0000000010001011
0000000000011101
0000000010100011
1111111111011111
1111111110001101
0000000001101001
1111111101101111
1111111110101111
1111111101110111
1111111111001011
0000000010010001
0000000010000001
1111111111011001
0000000000101011
0000000001010101
1111111101110011
0000000000111111
0000000001110010
1111111111000000
0000000001011001
0000000000110111
0000000000100011
1111111111100111
1111111110011000
1111111110101000
1111111110001000
1111111111010100
0000000000101101
0000000000101001
1111111101010011
1111111111011011
0000000000101000
0000000001110000
