00000000000000001011000010001110
00000000000000010011000111111001
11111111111111111101011000100011
11111111111111101000101010011111
00000000000000100000110101100000
00000000000000001111011001010011
00000000000000000001010011000011
00000000000000011010111101001001
11111111111111001011000001010001
00000000000000010101011100101001
00000000000000010111111010100101
11111111111111011000100011010101
11111111111111111111110101011101
11111111111111010110010100011001
00000000000000011111011010011001
11111111111111001011110111100101
11111111111111000101010110111110
00000000000000000011010111111000
00000000000000010011101101110111
00000000000000000100100011010101
00000000000000000000100110000000
11111111111111111110011111101110
00000000000000000011011010011011
00000000000000000100110010101101
11111111111111110111000101110101
11111111111111111010101100101110
11111111111111101000101111111111
00000000000000000000011100100011
11111111111111101101001010100101
00000000000000001011100011000010
00000000000000001110110001101111
11111111111111011000000001010101
11111111111111110101111010110010
00000000000000100100100101011110
11111111111111110011011100100101
11111111111111111110111001001001
00000000000000000011110011011000
11111111111111010100111001100100
11111111111110111001010011011001
00000000000000000000111111000101
00000000000000100101110110000010
11111111111111000111000100111001
00000000000000001101001010010101
11111111111111110110011011100000
11111111111111111000000001001000
00000000000000001000010001001001
11111111111111110001010111000101
11111111111111101101001010100010
11111111111111111100110101011110
11111111111111111110011100100111
00000000000000010010010011110000
00000000000000001010110110101011
11111111111111110000001010011110
11111111111111011001101010011011
00000000000000010011000000001100
11111111111111011111100001101011
11111111111111101011001110100101
00000000000000001111110110001000
00000000000000001100101100000111
11111111111111111010011001100101
11111111111111110001111100011011
00000000000000110010101010100100
00000000000000010101000011101001
00000000000000010010000110111111
11111111111111111100011110101000
00000000000000000111110100001001
11111111111111111000001111000010
11111111111111111101000111100111
00000000000000101000000000000100
00000000000000001110100010100101
11111111111111100101100010110110
11111111111111101101001011110111
11111111111111101101001000011010
11111111111111111101111000111101
11111111111111010100110000001100
00000000000000010110111110000101
00000000000000010110100111001100
00000000000000001100100010111011
00000000000000001001011100110010
11111111111111101111101010110111
11111111111111001111111110111011
11111111111111101100010001001001
11111111111111101101011100000100
00000000000000010011110111011010
11111111111111110110100010011111
11111111111111011000000110010011
00000000000000011110101100000110
11111111111111101010101011001110
00000000000000011111001011011100
11111111111111110100010011001100
11111111111111010101010101000010
00000000000000011001010000110101
11111111111111100111110111111100
00000000000000010000011010010010
00000000000000100010001000100110
00000000000000111000011101101101
11111111111111101101111100001000
00000000000000100011101110101010
11111111111111101101011010101111
00000000000001001000010001110110
00000000000000011101100001011110
00000000000000001000001001001000
11111111111111110111000100011011
11111111111111010010111000111000
00000000000000001100101111011011
11111111111111110000010110010000
11111111111111010001100010011100
11111111111111110000011001110100
11111111111111101011011111010111
00000000000000010111111110110100
11111111111111110110000111111010
11111111111111111010110010000000
00000000000000010011111100100111
00000000000000000010101101001100
11111111111111111101111010111110
00000000000000000011001100100010
00000000000000110110011000001111
11111111111111100011100100000000
11111111111111111100101011111100
00000000000000010000100000000010
00000000000000001101000101011111
11111111111111110010010111110111
00000000000000010000111010010001
00000000000001001111010000000010
11111111111111100110101101011001
11111111111111110001111111010001
11111111111111100111101110010011
11111111111111111000111110000010
00000000000000100000011100101111
11111111111111110011010111010110
11111111111111111001111011011001
11111111111111110000011001001101
00000000000000000111001100011111
11111111111111111101110000011000
11111111111111110010001111111001
00000000000000000110001110010101
00000000000000100101111010011011
11111111111111110101100010000110
00000000000000000011001001010100
11111111111111110010100001010001
00000000000000000110011010001101
00000000000000010101101000011110
11111111111111011000011011111000
11111111111111111110101001011111
00000000000000010100111011011000
11111111111111111110011111100101
00000000000000011000011110100111
11111111111111001000111011001110
11111111111111100001000111101100
11111111111111110110010101010011
00000000000000000100000001010101
11111111111111100100011100111010
11111111111111111001110001011110
11111111111111111011111000011011
11111111111111011011000100101111
00000000000000010100100101000001
00000000000000010110000011011110
00000000000000101100010010001011
00000000000000011001111000101101
11111111111111110100110100010001
00000000000000100001100000001111
11111111111111100110011101100010
00000000000000010000101111110011
00000000000000000000011001101110
00000000000000100001111100010011
00000000000000011000010010110010
00000000000000010011010111101111
11111111111111101000100000101010
11111111111111110011111100010101
11111111111111111000111111110101
00000000000000100010000111110110
00000000000000001010111011100001
00000000000000011010110100000001
00000000000000001000001101001001
00000000000000000100011111000000
11111111111111010001000110100101
11111111111111101110110011110110
11111111111111111101110010111110
11111111111111111010100000110001
00000000000000000111100110001001
11111111111111111010110111010010
00000000000000110000101101111110
00000000000000011001110110110011
11111111111111111110000111111111
11111111111111011100100101010011
00000000000000001001101001110100
11111111111111111101110100001001
11111111111111111111100001111011
11111111111111111000100100011101
00000000000000010100100011010010
11111111111111110100111100000011
11111111111111011010011010011011
11111111111111110101000010000100
11111111111111110101010100100011
00000000000000100101101001001000
11111111111111110111100001111111
00000000000000101001100000010100
11111111111111100011010100011011
11111111111111011010001011101000
11111111111111110110110001111011
11111111111111110110111100110001
00000000000000000000101000001101
11111111111111011011101110000000
00000000000000000011000100000001
11111111111111111011001101010101
11111111111111110010010011011001
00000000000000011110001010110110
11111111111111111010101010111101
11111111111111110100010100001011
00000000000000011010011101101010
11111111111111111111001101101101
00000000000000000100100110111001
11111111111111110110101111001111
11111111111111011100011000000010
11111111111111110001000011100001
00000000000000000000010100101011
11111111111111101001101100001110
11111111111111011111010110101000
11111111111111011111101001110001
11111111111111110011011111000100
11111111111111110111110100000010
11111111111111001100010001010010
00000000000000000110001111000011
00000000000000011001101111100110
00000000000000110101010110111010
00000000000000100001111001110011
11111111111111100101010010001101
00000000000000010010101110001101
11111111111111100011100111111110
11111111111111111101101011111101
00000000000000010011111000000111
11111111111111010010011001000111
11111111111111111111110011000000
11111111111111111011111110101101
11111111111111111001000101110101
00000000000000001110000111101000
11111111111111111001111011101000
00000000000000110010001001011101
00000000000000100111100001000011
00000000000000001100100000000110
00000000000000010110101011100110
00000000000000000000010110011111
00000000000000001110000110001001
00000000000000001001010110000010
11111111111111101100010010010000
11111111111111100111100010001001
00000000000000110001101100000101
11111111111111111010010101111010
00000000000000001001010000011010
11111111111111100000011001001010
00000000000000011010010111001000
11111111111111100100111100001111
00000000000000000010111001110110
11111111111111101000011101001010
11111111111111100100101111001000
11111111111111110111111110100101
