1111111111111111
0000000001101100
0000000100111011
1111111111010010
0000000000000011
1111111110101111
0000000110101010
1111111100100000
1111111101110001
1111111110101110
1111111110101001
0000001000100100
0000000000001001
0000000101110111
1111111100111110
1111111110010010
0000000000001010
0000000100010001
0000000010101000
0000000000000111
1111111111110011
1111111101101000
0000000101001000
0000000001100000
1111111110110110
1111111111110101
0000000111100100
0000000001101111
0000000100011101
1111110111111010
0000000000000100
1111111110001010
1111111000000100
1111111110011101
0000000000000001
1111111110000100
1111111111011001
1111111111111111
1111111101100100
0000000111101001
1111110111110110
0000000110001001
1111110011010001
1111111100011110
0000000001011001
1111111101010111
0000000010101110
1111111110011001
0000000101100100
1111111111100000
0000000100000001
0000000001101100
1111111111000000
0000000101011100
1111111101111101
0000000100010010
1111111110110100
1111111111010110
0000000101010011
1111111111100110
0000000010100100
1111110110100110
1111111110110011
1111111001100100
1111111011100000
0000000000101010
1111111111010001
0000000101100111
1111111111110111
0000000010100111
0000000001000010
0000000001111011
0000000011111010
0000000000010010
0000000110010111
1111111101000001
1111111010001111
0000000000001001
1111111111110110
0000000001000001
0000000101011111
0000000100111010
1111111001110011
1111111111001001
1111111010111011
1111111111001011
0000000101001111
0000000101010110
0000000011001111
1111111001111000
0000000000101001
1111111000001011
0000000000110111
1111111100001011
1111111110100101
1111111101111110
1111111101101101
1111111100101011
1111111001011101
1111111011111010
1111111110010000
0000000010000110
1111111001011010
1111111110101111
0000000000110011
1111111100110101
0000000011011011
0000000011010010
0000000011010100
1111111111101110
1111111110111010
0000000011000001
1111111000000001
1111111110011010
1111111101010010
0000000100011001
1111111011010001
1111111100111010
1111111111000000
1111111111011011
0000000001001001
0000000100101100
1111111110111110
1111110011110101
0000000001100101
1111111110110000
0000000111011000
0000000110011111
1111111110110101
1111111111111010
1111111011100101
1111111110011101
0000000011000000
0000000010000100
1111111000101111
1111111001011011
1111111100000111
1111111110100010
0000000000101001
0000000000100011
0000000001011100
0000000010001100
1111111100110011
1111111110010001
1111111011101001
0000000000000101
1111111100000101
1111111011101010
0000000010011100
1111111111101110
0000000110100101
1111111001110000
0000000110001001
0000001011000111
1111111110000101
1111110111110010
1111111100111110
1111110011010110
0000000000001101
0000000000001100
1111111011110001
0000000101110011
0000000001110001
0000000000101001
0000000000101110
0000000111111000
0000000110111010
1111111101001101
1111111010011111
0000000100001101
0000000000001001
1111111101111011
1111111001111110
0000000101001100
1111111111111000
0000000100100011
1111111101010000
0000001001110111
1111111100101110
0000000001000111
0000000101001010
0000000011111000
0000000011011110
1111111010010111
1111111110100000
1111111110111011
1111110111111000
0000000001111011
0000000111000010
0000000001011010
0000000010100000
0000000101010011
1111111111010001
0000000000110000
0000000000001000
0000000000001010
1111111101000000
0000000000011111
0000001001010110
0000000010010101
1111111111010001
0000000010111100
1111111111000110
0000000001101110
1111111110001010
0000000010010001
1111111110100000
1111111001100111
1111111111100010
1111111111001001
1111110111100010
0000000101101010
1111111101000000
1111110100101110
0000000010010000
0000000101011101
0000000000011100
1111111001101111
0000000001101010
0000000101101110
1111111111000010
0000000101111010
0000000001011100
1111111100000011
1111111111111110
0000001010001110
1111111101101111
0000000011101010
1111111110110101
0000001010111011
0000000110010110
0000000001100010
0000000000101010
1111111111100100
0000000011101101
1111111100111110
0000000000010011
1111111110111111
1111111100000110
1111111110100010
1111111110110110
1111111101110001
1111111111110010
1111111101110110
0000000100100111
1111111110010000
1111111111011001
0000000100011100
0000000101010110
0000000000011001
0000000000010110
1111111110000000
0000000011111001
1111111111001010
0000000010000011
1111111100001010
