0000000001010110
0000000010010111
1111111111101100
1111111101000101
0000000100000100
0000000001111101
0000000000001010
0000000011010111
1111111001011011
0000000010101010
0000000010111101
1111111011000110
1111111111111101
1111111010110110
0000000011111011
1111111001100010
1111111000101110
0000000000011001
0000000010011100
0000000000100011
0000000000000110
1111111111110111
0000000000011100
0000000000101001
1111111110111001
1111111111010101
1111111101001001
0000000000000001
1111111101101011
0000000001011101
0000000001110111
1111111011000001
1111111110110001
0000000100100001
1111111110011101
1111111111110101
0000000000011101
1111111010101001
1111110111001101
0000000000001001
0000000100101110
1111111000111001
0000000001101001
1111111110110100
1111111111000000
0000000001000011
1111111110001101
1111111101101100
1111111111100111
1111111111110100
0000000010010001
0000000001010100
1111111110000001
1111111011010010
0000000010010111
1111111011111110
1111111101011010
0000000001111100
0000000001100110
1111111111010011
1111111110001110
0000000110010100
0000000010100110
0000000010010001
1111111111100100
0000000000111100
1111111111000001
1111111111100110
0000000100111100
0000000001110110
1111111100101011
1111111101101100
1111111101101010
1111111111110001
1111111010101011
0000000010110110
0000000010110100
0000000001100101
0000000001001011
1111111110000000
1111111010000001
1111111101100010
1111111101101100
0000000010011111
1111111110110101
1111111011000100
0000000011110010
1111111101010111
0000000011111000
1111111110100000
1111111010101100
0000000011000101
1111111101000010
0000000010000100
0000000100001110
0000000111000011
1111111101101111
0000000100011011
1111111101101011
0000001000111111
0000000011101001
0000000001000001
1111111110111001
1111111010011001
0000000001100110
1111111110000011
1111111010001110
1111111110000011
1111111101011110
0000000010111111
1111111110110010
1111111111010111
0000000010011111
0000000000010100
1111111111101110
0000000000011010
0000000110101111
1111111100011110
1111111111100100
0000000010000100
0000000001101000
1111111110010011
0000000010000110
0000001001110101
1111111100110110
1111111110010011
1111111101000000
1111111111001001
0000000100000011
1111111110011010
1111111111010000
1111111110000100
0000000000111001
1111111111110000
1111111110010100
0000000000110010
0000000100101100
1111111110101101
0000000000011000
1111111110010011
0000000000110010
0000000010101101
1111111011000110
1111111111110111
0000000010100110
1111111111110011
0000000011000100
1111111001001001
1111111100001010
1111111110110011
0000000000100000
1111111100100101
1111111111001111
1111111111011110
1111111011011100
0000000010100010
0000000010101111
0000000101100010
0000000011001110
1111111110100110
0000000100001010
1111111100110101
0000000010000111
0000000000000001
0000000100001110
0000000011000011
0000000010011001
1111111101000111
1111111110100000
1111111111000110
0000000100001101
0000000001010101
0000000011011000
0000000001000000
0000000000100011
1111111010001101
1111111101111001
1111111111101101
1111111111010100
0000000000111011
1111111111010101
0000000110000101
0000000011001110
1111111111110011
1111111011100110
0000000001001101
1111111111110000
1111111111111101
1111111111000100
0000000010100101
1111111110101010
1111111011010101
1111111110101010
1111111110101011
0000000100101100
1111111110111101
0000000101001010
1111111100011101
1111111011010100
1111111110110111
1111111110111001
0000000000000011
1111111011100000
0000000000010111
1111111111011011
1111111110010011
0000000011110000
1111111111010111
1111111110100011
0000000011010011
1111111111111100
0000000000100011
1111111110110111
1111111011100111
1111111110001010
0000000000000011
1111111101001101
1111111011111100
1111111011111110
1111111110011100
1111111110111111
1111111001100110
0000000000110010
0000000011001110
0000000110100111
0000000100001010
1111111100101001
0000000010010101
1111111100011111
1111111111101110
0000000010011101
1111111010010111
1111111111111111
1111111111011111
1111111111001010
0000000001110000
1111111111010001
0000000110010001
0000000100111010
0000000001100100
0000000010110011
0000000000000010
0000000001110011
0000000001001010
1111111101100101
1111111100111110
0000000110001001
1111111111010010
0000000001001011
1111111100000101
0000000011010010
1111111100101010
0000000000010111
1111111101000011
1111111100101000
1111111111000010
