11111111111111111111110100000111
00000000000000001101100011001101
00000000000000100111110100101011
11111111111111111010100101101111
00000000000000000000100111010101
11111111111111110101110001101011
00000000000000110101001010000001
11111111111111100011111010011010
11111111111111101110000001101001
11111111111111110110000000100111
11111111111111110101000111101011
00000000000001000101001001101101
00000000000000000000111100011011
00000000000000101111011011001101
11111111111111100111101001000001
11111111111111110010010001110110
00000000000000000001001011011001
00000000000000100010010111110110
00000000000000010101000111001111
00000000000000000001010111111000
11111111111111111110010001010011
11111111111111101100111100101010
00000000000000101001011100111110
00000000000000001100001110001010
11111111111111110110001111001011
11111111111111111110101010111000
00000000000000111101000100000111
00000000000000001101101001101100
00000000000000100011111100001001
11111111111110111110111100110000
00000000000000000000110000100100
11111111111111110000110001100010
11111111111111000000000100111101
11111111111111110011100100010010
00000000000000000000001100101001
11111111111111110000001101100100
11111111111111111011000101011100
11111111111111111111111010001101
11111111111111101100100010100001
00000000000000111101001101000011
11111111111110111110011101111011
00000000000000110001001011010100
11111111111110011001101001011001
11111111111111100011010010101000
00000000000000001011000011001100
11111111111111101011000111000101
00000000000000010110000101110101
11111111111111110011001010100001
00000000000000101100110010110001
11111111111111111100001000000110
00000000000000100000100000010100
00000000000000001101110011111101
11111111111111111000010010001001
00000000000000101011101011110010
11111111111111101111111000001000
00000000000000100010101001110001
11111111111111110110100011110011
11111111111111111010100111011000
00000000000000101010110011001000
11111111111111111100110101000101
00000000000000010100011001010011
11111111111110110100100000011100
11111111111111110101111111010100
11111111111111001100000110111001
11111111111111011011110101111111
00000000000000000101001000100011
11111111111111111001101110111011
00000000000000101101010010101100
11111111111111111110101000010101
00000000000000010100110010010011
00000000000000001000001011001011
00000000000000001111001011111101
00000000000000011111100000000011
00000000000000000010010001101001
00000000000000110011101000000011
11111111111111101000000111111100
11111111111111010001011001111101
00000000000000000001011000101001
11111111111111111110110101111011
00000000000000001000001110001011
00000000000000101011110101010100
00000000000000100111101011101111
11111111111111001110000111010011
11111111111111111001100001000001
11111111111111010110101111111000
11111111111111111001000110111110
00000000000000101010001110101010
00000000000000101010110111111001
00000000000000011001111100100000
11111111111111001110100110011011
00000000000000000100111001101011
11111111111111000000010111110111
00000000000000000111000000000000
11111111111111100001010001111000
11111111111111110100010000101100
11111111111111101111100110001111
11111111111111101101111001010111
11111111111111100101010101011001
11111111111111001011011100000011
11111111111111011110111001101001
11111111111111110001101010011010
00000000000000010000110100110010
11111111111111001010100111101110
11111111111111110101101110100100
00000000000000000110010111110111
11111111111111100110100110010111
00000000000000011011010000110101
00000000000000011010010101111111
00000000000000011010101011101100
11111111111111111101110000000010
11111111111111110111001101000110
00000000000000011000011010100000
11111111111110111111110001100010
11111111111111110011000110100010
11111111111111101010001000011000
00000000000000100011011001000011
11111111111111011001111011011101
11111111111111100110011010111100
11111111111111110111101101101110
11111111111111111011001001100110
00000000000000001001000000100010
00000000000000100110000100101110
11111111111111110111101010110010
11111111111110011101110011000001
00000000000000001100100000101011
11111111111111110101111011101100
00000000000000111011010010010100
00000000000000110100011001110110
11111111111111110110010001000110
11111111111111111111000001011111
11111111111111011100011100011110
11111111111111110011111010111111
00000000000000011000011000110111
00000000000000010000101000110111
11111111111111000101010010101000
11111111111111001011001101000101
11111111111111100000110110100110
11111111111111110100000111011011
00000000000000000101000100011110
00000000000000000100011010100001
00000000000000001011100100011101
00000000000000010001101010011111
11111111111111100101111110100100
11111111111111110010010011110011
11111111111111011100101111101010
00000000000000000000110011111001
11111111111111100000100011000010
11111111111111011101001111110111
00000000000000010011110011010010
11111111111111111101100101001100
00000000000000110101000100011001
11111111111111001101100000000101
00000000000000110001001100000010
00000000000001011001010100001011
11111111111111110000111010001100
11111111111110111101011011001111
11111111111111100111101100010110
11111111111110011010011101100100
00000000000000000001101100101101
00000000000000000001010100011001
11111111111111011101111011110110
00000000000000101110110100111010
00000000000000001110011101100101
00000000000000000101010110011010
00000000000000000101011100110111
00000000000000111111001110010100
00000000000000110111101011011010
11111111111111101001101000100001
11111111111111010011011101101110
00000000000000100001110100011100
00000000000000000000111101111011
11111111111111101110110111111100
11111111111111001111110100110101
00000000000000101001100001111010
11111111111111111110110010001110
00000000000000100100101010111101
11111111111111101001101010000000
00000000000001001111100110011010
11111111111111100101011100100110
00000000000000001000101000111110
00000000000000101001110100001011
00000000000000011111000011110101
00000000000000011011011110011110
11111111111111010010001111100000
11111111111111110011101111001000
11111111111111110111010011000100
11111111111110111110101001000000
00000000000000001111101001011010
00000000000000111000101011010001
00000000000000001011011101001001
00000000000000010011111011101000
00000000000000101010101111001100
11111111111111111010000000010110
00000000000000000110010111110110
00000000000000000000111111110101
00000000000000000001001011101111
11111111111111100111100111010101
00000000000000000011110100011100
00000000000001001011010001001010
00000000000000010010101001011010
11111111111111111010000011110010
00000000000000010111101101000000
11111111111111111000110100011111
00000000000000001101100100111011
11111111111111110001001100101011
00000000000000010010010010000010
11111111111111110011111001100010
11111111111111001100101001000000
11111111111111111100010101001011
11111111111111111001010000001010
11111111111110111011110010110000
00000000000000101101110010010000
11111111111111100111110011101011
11111111111110100100111001011010
00000000000000010001110001100110
00000000000000101011111011100101
00000000000000000011100101011111
11111111111111001101111000011010
00000000000000001101010111111010
00000000000000101101111000010010
11111111111111111000001011100111
00000000000000101111101110001010
00000000000000001011100111101100
11111111111111100000000110001001
11111111111111111111110010011110
00000000000001010010010011000001
11111111111111101101101001011101
00000000000000011101011001010001
11111111111111110110010100100001
00000000000001010111110011111001
00000000000000110011000100010010
00000000000000001100011011000101
00000000000000000101001111010000
11111111111111111100001111100001
00000000000000011101101010000111
11111111111111100111011001000101
00000000000000000010011101010001
11111111111111111000000101100101
11111111111111100000011110000010
11111111111111110100001101111101
11111111111111110111000100010010
11111111111111101110000110011110
11111111111111111110001100110110
11111111111111101110100111010011
00000000000000100101001000110110
11111111111111110010001000100001
11111111111111111011001110110110
00000000000000100011010011100111
00000000000000101010111001100110
00000000000000000011100101000010
00000000000000000010101010010000
11111111111111110000000111011111
00000000000000011111010101001010
11111111111111111000111011100011
00000000000000010000100111100100
11111111111111100001011110011011
