11111111111111111011110110011000
00000000000000001010001100001011
00000000000000001110011011110110
00000000000000000101011110111011
11111111111111111011000100100000
11111111111111111000101111000001
00000000000000000001111101010000
11111111111111111111000111110011
00000000000000001000001100111001
11111111111111110101010001100111
11111111111111111010010001001101
11111111111111110111111111111011
00000000000000000000101100010110
11111111111111110011111111011010
00000000000000000011101111111010
11111111111111110111011001101110
00000000000000000110011010000000
11111111111111110011001111000010
00000000000000011111000110001110
00000000000000000011000000010100
11111111111111110101010011010010
00000000000000010010111110111111
11111111111111110111110110010010
11111111111111111100111001011101
00000000000000010001010001001101
11111111111111111010101001011110
11111111111111110110100000000101
11111111111111100111101110111100
11111111111111110100001100111010
00000000000000011000111101001111
00000000000000010011000000111000
11111111111111101100101001110011
11111111111111100001001010111000
00000000000000000011111100001110
11111111111111100111000111100110
00000000000000000000111101111100
11111111111111011110000110100100
11111111111111101110000001111110
11111111111111100010111011011010
00000000000000010001001010000000
00000000000000001101100111000111
11111111111111110111100000101011
00000000000000100101000011000011
11111111111111111100000011101011
11111111111111110011001100011010
00000000000000010110001001011010
11111111111111110010000110011000
11111111111111011101101010010100
00000000000000001100000000100000
11111111111111110101101110111011
00000000000000001100010010101110
11111111111111111110010110011011
00000000000000000101101010110010
11111111111111110110111110110010
00000000000000000000010110001110
11111111111111101011110000001010
00000000000000000000011011010110
11111111111111101100011011011110
00000000000000000010101101001010
11111111111111111110001011111010
00000000000000011010101100001001
00000000000000010110000101100001
00000000000000000100001011110001
11111111111111101101110110011001
11111111111111110010110110000101
00000000000000000111011001010010
00000000000000001101000110000001
00000000000000001011001101001100
00000000000000001010110100111100
11111111111111111111110001001011
11111111111111110110101001111010
11111111111111111010101101111111
11111111111111010011111011110101
00000000000000000011101011100010
00000000000000000010100101001011
00000000000000001100001100010010
00000000000000001010001111001001
00000000000000000100010010100111
00000000000000011010010110010011
11111111111111100010000010010001
00000000000000001000111000011011
11111111111111110100001010110000
11111111111111111100011000000101
11111111111111110101000101110000
00000000000000011010000000011111
11111111111111111101110011001110
00000000000000011000101000000001
00000000000000000010100000101010
00000000000000001111001001101110
00000000000000011110110001010101
11111111111111111111111100111100
00000000000000000010011111010101
11111111111111111001110010101100
00000000000000011001101100101010
00000000000000100110011001110010
00000000000000000011001000000000
00000000000000000000001001110101
11111111111111110110101000001001
11111111111111101010001000011011
00000000000000000001110110001011
11111111111111111001111110110010
11111111111111101010011101110100
00000000000000000100110100110110
11111111111111011010001100001100
00000000000000010011010010010101
00000000000000010011011000110000
00000000000000000101110101010101
11111111111111110100010011001010
11111111111111100000011110011011
00000000000000000100011001111001
00000000000000010010010010101111
00000000000000010111101100000001
11111111111111101011110011100011
11111111111111111101011000011110
00000000000000000101001100110011
11111111111111111100001011111000
11111111111111111000100101011111
11111111111111111111101111011010
11111111111111111111011000011111
00000000000000011000001101101100
11111111111111110010100010100001
11111111111111101110001111111111
11111111111111111110100000101011
00000000000000000101101001011101
11111111111111101000110101111111
11111111111111111100111001101010
11111111111111101011011010000001
11111111111111110001010110100010
11111111111111111110110001010000
00000000000000000101010111000100
11111111111111100011001100100010
11111111111111101101011101100110
11111111111111101100110010100110
11111111111111111011010101100001
11111111111111111100001010010000
11111111111111111101010100011101
00000000000000001000100001000100
00000000000000011111111001101110
11111111111111100111110101101010
00000000000000001111110011001100
00000000000000000010001100001100
11111111111111111100000001111101
11111111111111101010101001010010
00000000000000000111101011110101
00000000000000000010010110110101
11111111111111111100100010101101
00000000000000000010000011100101
11111111111111011010010111111001
00000000000000000100100111000001
00000000000000011111011011001000
11111111111111110101110001010111
00000000000000010010111100110100
11111111111111011000001010011111
11111111111111011101100110110100
00000000000000000111011101011001
00000000000000000111101001111000
11111111111111111101100111010101
00000000000000001000110001010000
00000000000000011111011001111111
11111111111111111111111010011000
11111111111111100001101010110100
00000000000000101110010110011001
00000000000000010001011110010010
00000000000000000000101000011101
11111111111111110111000001111110
00000000000000001101010110110100
00000000000000000001010011111110
11111111111111111100001010011100
11111111111111110011101001000101
00000000000000000000101100111101
11111111111111100001110101100101
00000000000000000111110000001001
00000000000000010001100101111111
00000000000000001011111010001010
11111111111111110001001011100101
11111111111111101110111011100010
00000000000000001111111110001001
00000000000000011100010110100111
11111111111111110100110111111011
00000000000000000101010100010001
11111111111111011110101110011011
00000000000000010111000001010101
00000000000000001111101011000001
11111111111111110111110100101111
11111111111111111101100001101101
00000000000000100001111001010100
00000000000000000110100111010101
00000000000000001100001001101110
11111111111111111101011011101111
00000000000000001010110110010111
11111111111111111011100011111101
00000000000000000001001001000001
11111111111111110011001110000010
00000000000000001101000010110101
00000000000000001110001111110000
11111111111111111011100000110001
00000000000000000110110100000010
11111111111111111011000010111000
11111111111111011010010001010000
11111111111111110111010101111010
11111111111111101111000011101101
11111111111111110100000110000011
00000000000000000101001110100001
11111111111111100000001010001011
00000000000000010000111010100101
11111111111111111100100010011010
00000000000000100001001110011011
11111111111111110111001100100110
11111111111111110111111110011111
11111111111111100110111100000010
11111111111111111001101000111111
00000000000000011001111011000100
00000000000000000111111110110110
11111111111111100111101010100010
11111111111111111000111010111010
11111111111111110000011010000010
11111111111111111111010111110111
00000000000000101110101111101100
11111111111111110100010001011011
11111111111111111111110110110010
11111111111111111100111111111111
11111111111111110010010110111100
00000000000000010011010010101001
11111111111111111000001001011100
11111111111111111111011100111000
00000000000000100111100111000000
00000000000000000111101101011110
00000000000000000001010110110110
00000000000000000011000011111111
11111111111111110010111101001001
00000000000000010111010010111101
11111111111111101000100001011111
00000000000000001001110000001000
00000000000000010110000111100011
11111111111111101001000010010010
00000000000000001110010001100111
11111111111111110011100001011111
00000000000000100101100111101101
00000000000000010111001101100111
11111111111111101111101110111001
00000000000000011001100110111110
11111111111111110111001011111001
00000000000000000011001011011000
11111111111111111000111000001101
11111111111111110111010111111110
11111111111111111000011001010010
00000000000000010001110010111110
00000000000000000001011011000010
11111111111111110110101100010000
11111111111111101000110000010000
11111111111111101011001011000000
00000000000000001100001101001100
11111111111111101111011001000110
00000000000000010100010100111000
11111111111111100101001100000000
11111111111111100010100011101010
