1111110010011000
0000000010100001
0000000000011101
1111111101011101
0000000000110000
0000001010011011
1111111010110011
0000001001110011
0000001001000101
1111111111110111
1111110110001000
1111111110000010
1111111111001110
0000000100010011
0000000000010100
0000000010011010
0000000011001010
0000000110101101
0000000000111101
1111111001011011
0000000101011110
0000000011001011
0000000100000101
0000001010001011
0000000110110001
0000000000010111
0000000111001110
1111111111011010
0000001010110100
1111110101111011
0000000001011100
1111110111000100
0000000000100000
0000000000010011
1111111101100110
1111110111010010
1111111110110000
1111110100101101
1111111000011000
1111111111100000
1111111011001111
0000001011101101
1111111101110110
0000000010000011
0000000101101000
0000000100100000
1111110001101110
0000000000101100
0000000110011110
1111111100011111
1111110111001100
1111111110010000
1111111011100100
0000000001011101
1111110101111100
0000001001100110
1111111000110111
0000001001100101
0000000111001100
0000000111101111
0000000001111000
1111101111111010
1111111100110010
1111110110110010
1111111011000111
1111111001010110
1111110111011011
1111111110110110
0000001100100100
1111111101101000
1111110111001010
1111111001000100
1111111110101011
0000000110111111
0000000001101111
0000000111011011
1111111100100000
0000000111110011
1111111000010111
1111111000010101
1111111111010101
0000000111110110
1111111110100101
1111111010011110
0000001010110110
0000000011101100
0000000000000000
0000000111000000
0000000101001001
1111111011100101
0000000100010101
1111111101101001
1111111111110110
1111111110010001
0000000011001011
1111111110010111
0000000011011100
0000000010011001
1111111110101110
0000001111011001
0000000100100011
1111111101111000
1111111110101000
1111111011000001
1111111011000000
0000000001101111
0000000011010111
0000010010001110
0000000011001110
0000001011011011
1111111101100001
1111110110110010
1111111011001110
0000000010010001
1111110110001110
0000001010001011
1111110110000101
1111111010010000
1111111101000110
1111111001010101
1111111101010010
0000001011010011
1111111110011001
1111111000001010
0000010000101110
0000000000100001
0000000010010101
1111111110011100
0000001010100100
1111111110001001
0000000001100011
1111111010011001
1111111110111101
1111111000010110
1111111100110011
0000000101011010
1111111001001110
1111110101100100
1111111010101110
0000001011101100
0000001001110011
0000001111010110
1111110111100110
0000000101000111
0000000110111010
1111111011010001
0000000011000001
1111111101110111
0000000001010011
1111111000110000
0000001001101001
1111111010011100
0000000101100000
0000001010101010
1111111101101110
1111110100010100
1111111001100001
1111111110100100
1111111011001110
1111111110001011
1111111100001001
1111111000010100
0000000101010000
0000000001000010
0000000011110001
0000000001101101
0000000100000010
0000000111111000
0000000111001010
1111111111000100
0000000011101011
1111111110001011
1111111011111110
1111111001011110
1111111101111001
1111111010010000
0000001001001011
1111111110101100
0000001001001110
1111111111011000
0000001100000101
0000000101100111
0000000110001110
1111111011110100
0000000100001010
1111111101010000
1111110110010011
0000000001011111
0000000101000100
0000001011011010
0000000001011011
1111110110100000
1111111001010011
1111111101000111
0000000000010111
1111111011101101
0000001010011011
0000000011011010
1111111000010110
1111111011101100
1111111111010101
0000000010100110
0000001001110100
1111110100110101
0000000010001111
1111110111001100
1111111011101011
1111111011100100
0000000001110011
0000000001001101
1111111011001111
0000000111110101
0000001000010001
1111111010000010
1111111110100000
0000000111000000
0000000000001101
1111111001110010
0000001101010110
0000000011011101
1111111111101101
1111111101001100
1111111010101111
1111111101001100
0000001010100100
1111111110001100
0000000100101011
1111111001110100
1111110100001001
0000000001001100
0000000100110101
1111110101010011
0000000001010010
0000000101110100
1111111011101111
0000000010000111
1111111101100000
0000001010001001
0000000000111111
1111111111100101
0000000010101000
0000000100100100
1111111000001001
0000000011110010
1111111111011001
1111111010010100
1111111100011001
1111111101001111
0000001011111110
0000001000000100
1111111010000001
0000001001100111
0000000000111010
1111111001001111
0000000111100111
1111110111010101
