0000000001010100
0000000001001100
0000000001011001
0000000000010011
1111111111010100
0000000001111110
1111111111010101
1111111111100111
0000000000000100
1111111100100010
1111111100101000
1111111111110110
1111111111011110
0000000010000000
1111111101010001
1111111111110011
1111111110111011
0000000000010111
1111111101011111
1111111111000001
1111111110110010
0000000001100110
1111111101100010
0000000001011000
1111111110111001
1111111110111101
1111111111011001
0000000001001011
0000000000100101
0000000000001111
0000000000000010
0000000010110000
1111111101001110
1111111111110010
0000000010011001
0000000000001011
1111111101111101
0000000001011011
0000000001001101
1111111101110101
0000000000111001
1111111101100111
0000000000111110
1111111111101110
0000000010110100
0000000000010000
0000000000000011
0000000011100001
0000000000100100
1111111110000110
1111111110010000
1111111111011110
0000000001111110
0000000000011010
1111111110110101
0000000000101101
1111111111111101
0000000010011101
1111111101110111
1111111110111001
1111111110011000
0000000010000000
0000000001001110
0000000010100000
0000000000000011
0000000000000001
0000000010001101
1111111111110001
1111111111010000
1111111111010100
1111111110000100
0000000000010100
1111111111000101
0000000000100011
0000000001001010
1111111111011110
1111111110101101
1111111111110001
1111111110101110
0000000010001000
1111111110100101
1111111110000111
1111111101110110
1111111111111100
1111111101101000
1111111110110010
1111111111111110
1111111111101110
1111111111111101
0000000010101011
0000000000100000
0000000001110000
0000000001111101
0000000001100011
0000000001011110
0000000001011010
1111111111011111
0000000010001101
0000000001001101
1111111111010011
1111111111000110
1111111101000100
1111111101111101
0000000001000001
1111111110000001
1111111111100111
0000000001100001
0000000001111011
0000000000000011
1111111101100001
0000000010000001
1111111110110011
0000000010001000
1111111111110100
0000000010011111
0000000000000101
1111111101101011
0000000000011011
0000000000001101
1111111110011111
1111111111011001
0000000001011001
1111111111110110
1111111110100100
1111111111101001
1111111100111101
0000000010110000
0000000000101110
0000000000101000
1111111111010000
0000000001110110
0000000001100000
0000000001101000
0000000000011000
1111111111111101
1111111111111001
0000000000001111
1111111111111001
0000000010100000
0000000001000000
0000000000100000
1111111110011010
0000000001011101
1111111111010001
0000000000100101
1111111101000101
1111111110110011
0000000010000111
0000000000000010
0000000010010110
0000000011001100
0000000000110010
0000000000001010
0000000001100010
0000000000110101
1111111101011001
0000000000001111
1111111101000001
1111111110000001
0000000000100011
0000000011001110
1111111111010000
0000000000111110
0000000010110110
1111111111011000
1111111101110110
0000000000100110
0000000001000100
0000000001101010
1111111110111010
1111111111010010
1111111111100100
1111111111001000
1111111110100110
1111111110011100
0000000001110010
1111111111111100
0000000001101000
1111111110101011
0000000001011011
1111111101011110
1111111111010010
0000000001110100
0000000001111100
1111111110010001
1111111111110001
1111111111000100
0000000001010110
0000000000100100
1111111110100000
1111111101101101
0000000000100111
0000000000111101
1111111110001111
0000000000111101
0000000001000101
1111111101010011
0000000000111111
1111111111011101
0000000000001111
1111111111011001
1111111111100001
1111111111110001
0000000001001111
0000000010001010
0000000000100110
1111111101100101
0000000000010101
1111111110111000
1111111111111000
1111111111110101
1111111100110101
1111111110100111
0000000001111111
0000000001001111
1111111111011101
1111111110001111
1111111101110011
1111111111110111
0000000010111011
1111111110101110
0000000010001010
0000000000011001
1111111111101001
0000000000100011
0000000000001001
0000000001000000
0000000010011000
0000000010011010
1111111111011010
0000000010101010
0000000000101010
0000000000110101
0000000010010001
1111111110110011
0000000000011111
1111111111111011
0000000000111001
0000000000011100
0000000011010110
0000000010000101
1111111111010111
1111111110000111
1111111111111001
0000000001001001
1111111111110111
0000000001011110
1111111111011100
0000000000010111
1111111101001101
0000000000011010
1111111101110100
1111111111101010
0000000011100110
0000000000110000
0000000011000110
